Date,Away,AwayPts,Home,HomePts,Diff
2023-11-14,Prairie View A&M,79,Abilene Christian,74,5
2023-11-19,Fordham,45,Abilene Christian,59,-14
2023-12-02,Stephen F. Austin,79,Abilene Christian,74,5
2023-12-06,Northern Arizona,78,Abilene Christian,76,2
2023-12-10,Howard Payne,69,Abilene Christian,120,-51
2023-12-17,UTEP,82,Abilene Christian,88,-6
2023-11-06,Portland St.,62,Air Force,55,7
2023-11-16,Lindenwood,58,Air Force,76,-18
2023-11-17,William & Mary,71,Air Force,80,-9
2023-11-19,Nebraska Omaha,56,Air Force,58,-2
2023-11-22,VMI,54,Air Force,64,-10
2023-12-09,Eastern Washington,73,Air Force,68,5
2023-12-21,Northern Colorado,83,Air Force,79,4
2023-11-10,Southern Miss,54,Akron,72,-18
2023-11-14,Heidelberg,56,Akron,114,-58
2023-11-19,FIU,71,Akron,77,-6
2023-11-20,Utah St.,65,Akron,62,3
2023-11-21,Drake,79,Akron,59,20
2023-12-05,Bradley,52,Akron,67,-15
2023-12-17,Miami Hamilton,45,Akron,88,-43
2023-12-21,Gardner Webb,90,Akron,94,-4
2023-12-30,St. Bonaventure,62,Akron,61,1
2023-11-06,Morehead St.,73,Alabama,105,-32
2023-11-10,Indiana St.,80,Alabama,102,-22
2023-11-14,South Alabama,46,Alabama,102,-56
2023-11-17,Mercer,67,Alabama,98,-31
2023-11-28,Clemson,85,Alabama,77,8
2023-12-04,Arkansas St.,65,Alabama,89,-24
2023-12-09,Purdue,92,Alabama,86,6
2023-12-23,Eastern Kentucky,67,Alabama,111,-44
2023-12-30,Liberty,56,Alabama,101,-45
2023-11-29,Tennessee St.,83,Alabama A&M,85,-2
2023-12-13,UAB,93,Alabama A&M,82,11
2023-12-16,Chattanooga,88,Alabama A&M,72,16
2023-11-14,Oglethorpe,51,Alabama St.,115,-64
2023-12-03,MUW,60,Alabama St.,80,-20
2023-12-19,USC,79,Alabama St.,59,20
2023-11-21,Army,59,Albany,62,-3
2023-11-29,Boston University,72,Albany,86,-14
2023-12-02,Dartmouth,68,Albany,73,-5
2023-12-05,SUNY Potsdam,59,Albany,98,-39
2023-12-19,Sacred Heart,79,Albany,93,-14
2023-11-08,Xavier LA,62,Alcorn St.,70,-8
2023-11-13,Siena,58,American,78,-20
2023-11-16,NJIT,73,American,87,-14
2023-11-22,Mount St. Mary's,65,American,68,-3
2023-11-26,Hood,74,American,103,-29
2023-12-02,Saint Francis,75,American,73,2
2023-11-07,Oakland City,49,Appalachian St.,87,-38
2023-11-21,UNC Wilmington,56,Appalachian St.,86,-30
2023-11-26,Austin Peay,58,Appalachian St.,78,-20
2023-11-29,East Tennessee St.,61,Appalachian St.,72,-11
2023-12-03,Auburn,64,Appalachian St.,69,-5
2023-12-05,Central Pennsylvania,35,Appalachian St.,111,-76
2023-12-21,UNC Asheville,76,Appalachian St.,63,13
2023-12-30,Louisiana Monroe,55,Appalachian St.,67,-12
2023-11-06,Morgan St.,59,Arizona,122,-63
2023-11-13,Southern,59,Arizona,97,-38
2023-11-17,Belmont,68,Arizona,100,-32
2023-11-19,UT Arlington,56,Arizona,101,-45
2023-11-23,Michigan St.,68,Arizona,74,-6
2023-12-02,Colgate,55,Arizona,82,-27
2023-12-09,Wisconsin,73,Arizona,98,-25
2023-12-20,Alabama,74,Arizona,87,-13
2023-12-23,Florida Atlantic,96,Arizona,95,1
2023-11-11,Texas Southern,52,Arizona St.,63,-11
2023-11-16,UMass Lowell,69,Arizona St.,71,-2
2023-11-23,BYU,77,Arizona St.,49,28
2023-11-24,Vanderbilt,67,Arizona St.,82,-15
2023-11-29,Sam Houston St.,61,Arizona St.,78,-17
2023-12-03,San Francisco,61,Arizona St.,72,-11
2023-12-06,SMU,74,Arizona St.,76,-2
2023-12-20,Northwestern,65,Arizona St.,46,19
2023-11-06,Alcorn St.,59,Arkansas,93,-34
2023-11-10,Gardner Webb,68,Arkansas,86,-18
2023-11-13,Old Dominion,77,Arkansas,86,-9
2023-11-17,UNC Greensboro,78,Arkansas,72,6
2023-11-23,Memphis,84,Arkansas,79,5
2023-11-24,North Carolina,87,Arkansas,72,15
2023-11-29,Duke,75,Arkansas,80,-5
2023-12-04,Furman,83,Arkansas,97,-14
2023-12-16,Lipscomb,66,Arkansas,69,-3
2023-12-21,Abilene Christian,73,Arkansas,83,-10
2023-12-30,UNC Wilmington,90,Arkansas,106,-16
2023-11-09,Champion Christian,73,Arkansas Pine Bluff,116,-43
2023-11-11,Southwestern Christian,68,Arkansas Pine Bluff,112,-44
2023-11-18,Incarnate Word,100,Arkansas Pine Bluff,81,19
2023-11-27,Arkansas Baptist,60,Arkansas Pine Bluff,85,-25
2023-12-18,Ecclesia,75,Arkansas Pine Bluff,125,-50
2023-11-14,Alcorn St.,86,Arkansas St.,100,-14
2023-11-25,UT Rio Grande Valley,58,Arkansas St.,75,-17
2023-11-28,Jackson St.,75,Arkansas St.,71,4
2023-12-09,UAB,68,Arkansas St.,87,-19
2023-11-06,Marist,71,Army,55,16
2023-11-17,Quinnipiac,67,Army,58,9
2023-11-29,Central Connecticut,79,Army,51,28
2023-12-01,SUNY Maritime,39,Army,74,-35
2023-12-05,Le Moyne,51,Army,68,-17
2023-12-17,Stony Brook,78,Army,74,4
2023-12-30,US Merchant Marine,50,Army,58,-8
2023-11-10,Southeastern Louisiana,71,Auburn,86,-15
2023-11-17,St. Bonaventure,60,Auburn,77,-17
2023-11-21,Alabama A&M,54,Auburn,84,-30
2023-11-29,Virginia Tech,57,Auburn,74,-17
2023-12-09,Indiana,76,Auburn,104,-28
2023-12-13,UNC Asheville,62,Auburn,87,-25
2023-12-17,USC,75,Auburn,91,-16
2023-12-22,Alabama St.,62,Auburn,82,-20
2023-12-30,Chattanooga,66,Auburn,101,-35
2023-11-06,Life,72,Austin Peay,90,-18
2023-11-14,Fisk,52,Austin Peay,79,-27
2023-11-20,Tarleton St.,66,Austin Peay,59,7
2023-11-22,Sacramento St.,71,Austin Peay,74,-3
2023-11-29,Morehead St.,61,Austin Peay,50,11
2023-12-05,Midway,44,Austin Peay,98,-54
2023-12-09,Murray St.,49,Austin Peay,53,-4
2023-12-22,Ohio,67,Austin Peay,71,-4
2023-11-06,Houston Christian,63,BYU,110,-47
2023-11-10,San Diego St.,65,BYU,74,-9
2023-11-15,Southeastern Louisiana,48,BYU,105,-57
2023-11-18,Morgan St.,50,BYU,93,-43
2023-11-24,N.C. State,86,BYU,95,-9
2023-12-01,Fresno St.,56,BYU,85,-29
2023-12-05,Evansville,55,BYU,96,-41
2023-12-13,Denver,74,BYU,90,-16
2023-12-16,Georgia St.,54,BYU,86,-32
2023-12-22,Bellarmine,59,BYU,101,-42
2023-12-30,Wyoming,68,BYU,94,-26
2023-11-07,Goshen,40,Ball St.,101,-61
2023-11-11,Old Dominion,68,Ball St.,73,-5
2023-11-14,Oakland City,51,Ball St.,92,-41
2023-11-21,USC Upstate,58,Ball St.,75,-17
2023-11-24,Arkansas Pine Bluff,74,Ball St.,92,-18
2023-12-02,Bellarmine,58,Ball St.,67,-9
2023-12-10,SIU Edwardsville,71,Ball St.,83,-12
2023-12-16,Indiana St.,83,Ball St.,72,11
2023-11-07,Auburn,82,Baylor,88,-6
2023-11-09,John Brown,70,Baylor,96,-26
2023-11-12,Gardner Webb,62,Baylor,77,-15
2023-11-14,UMKC,61,Baylor,99,-38
2023-11-28,Nicholls St.,70,Baylor,108,-38
2023-12-02,Northwestern St.,40,Baylor,91,-51
2023-12-05,Seton Hall,60,Baylor,78,-18
2023-12-22,Mississippi Valley St.,48,Baylor,107,-59
2023-11-20,Morehead St.,64,Bellarmine,51,13
2023-11-21,Midway,56,Bellarmine,77,-21
2023-12-04,Boyce,54,Bellarmine,88,-34
2023-12-07,Berea,59,Bellarmine,98,-39
2023-12-16,Evansville,70,Bellarmine,61,9
2023-11-06,Georgia St.,87,Belmont,89,-2
2023-11-14,Berry,59,Belmont,93,-34
2023-11-24,Monmouth,93,Belmont,84,9
2023-12-02,Valparaiso,68,Belmont,77,-9
2023-12-06,Lipscomb,71,Belmont,72,-1
2023-12-20,Arkansas St.,70,Belmont,74,-4
2023-11-10,Trinity FL,46,Bethune Cookman,113,-67
2023-11-15,Trinity Baptist,63,Bethune Cookman,104,-41
2023-11-20,Charleston Southern,73,Bethune Cookman,79,-6
2023-11-25,Delaware St.,72,Bethune Cookman,64,8
2023-12-01,Incarnate Word,82,Bethune Cookman,96,-14
2023-11-12,Keystone,50,Binghamton,104,-54
2023-11-18,Marist,59,Binghamton,82,-23
2023-11-25,Army,68,Binghamton,75,-7
2023-12-09,Le Moyne,79,Binghamton,91,-12
2023-12-19,Niagara,69,Binghamton,74,-5
2023-12-30,Marywood,52,Binghamton,108,-56
2023-11-07,Vanguard,55,Boise St.,89,-34
2023-11-12,San Francisco,58,Boise St.,63,-5
2023-11-24,VCU,61,Boise St.,65,-4
2023-11-26,Butler,70,Boise St.,56,14
2023-12-01,Saint Mary's,60,Boise St.,63,-3
2023-12-05,North Texas,64,Boise St.,69,-5
2023-12-09,Western Oregon,70,Boise St.,109,-39
2023-12-12,Northwestern St.,54,Boise St.,95,-41
2023-12-17,Cal St. Fullerton,65,Boise St.,88,-23
2023-12-29,Utah Valley,63,Boise St.,85,-22
2023-11-06,Fairfield,70,Boston College,89,-19
2023-11-15,Richmond,61,Boston College,68,-7
2023-11-18,Harvard,64,Boston College,73,-9
2023-12-02,N.C. State,84,Boston College,78,6
2023-12-05,Central Connecticut,68,Boston College,82,-14
2023-12-08,Holy Cross,64,Boston College,95,-31
2023-12-21,Lehigh,69,Boston College,85,-16
2023-11-16,Bryant,79,Boston University,95,-16
2023-11-26,Northern Vermont   Joh,49,Boston University,90,-41
2023-12-06,Maine,74,Boston University,65,9
2023-12-22,UMass Lowell,71,Boston University,63,8
2023-12-30,Merrimack,63,Boston University,74,-11
2023-11-06,Chicago St.,41,Bowling Green,70,-29
2023-11-11,Arkansas St.,75,Bowling Green,81,-6
2023-11-17,Bellarmine,85,Bowling Green,67,18
2023-11-24,Western Kentucky,72,Bowling Green,65,7
2023-11-25,Lipscomb,61,Bowling Green,82,-21
2023-11-26,Canisius,73,Bowling Green,77,-4
2023-12-10,Ohio Dominican,49,Bowling Green,97,-48
2023-12-16,UMKC,69,Bowling Green,79,-10
2023-12-19,Hampton,65,Bowling Green,75,-10
2023-12-22,Siena Heights,58,Bowling Green,79,-21
2023-11-11,Utah St.,66,Bradley,72,-6
2023-11-14,Tarleton St.,63,Bradley,86,-23
2023-11-25,Vermont,70,Bradley,79,-9
2023-12-02,Indiana St.,85,Bradley,77,8
2023-12-15,Cleveland St.,76,Bradley,69,7
2023-12-21,SIU Edwardsville,64,Bradley,75,-11
2023-12-28,Truman St.,47,Bradley,69,-22
2023-11-11,Loyola MD,77,Brown,75,2
2023-11-16,Rhode Island College,51,Brown,92,-41
2023-11-25,UMKC,83,Brown,93,-10
2023-12-01,Bryant,69,Brown,66,3
2023-12-22,Siena,67,Brown,71,-4
2023-11-06,Manhattan,61,Bryant,59,2
2023-11-08,Fisher,79,Bryant,140,-61
2023-11-20,Howard,61,Bryant,67,-6
2023-11-27,Springfield,74,Bryant,108,-34
2023-12-16,Towson,93,Bryant,101,-8
2023-12-22,Drexel,86,Bryant,104,-18
2023-11-06,Delaware,78,Bucknell,57,21
2023-11-20,Southern Indiana,56,Bucknell,67,-11
2023-11-29,Princeton,85,Bucknell,71,14
2023-12-16,Radford,70,Bucknell,63,7
2023-12-30,Saint Peter's,67,Bucknell,58,9
2023-11-06,Fairleigh Dickinson,92,Buffalo,86,6
2023-11-11,South Alabama,70,Buffalo,56,14
2023-11-15,Roberts Wesleyan,83,Buffalo,89,-6
2023-11-20,Hofstra,102,Buffalo,68,34
2023-11-21,Louisiana,68,Buffalo,60,8
2023-11-22,Iona,89,Buffalo,64,25
2023-12-02,St. Bonaventure,80,Buffalo,65,15
2023-12-09,Western Kentucky,82,Buffalo,65,17
2023-12-29,Niagara,69,Buffalo,63,6
2023-11-06,Eastern Michigan,55,Butler,94,-39
2023-11-10,Southeast Missouri St.,56,Butler,91,-35
2023-11-13,East Tennessee St.,47,Butler,81,-34
2023-11-23,Florida Atlantic,91,Butler,86,5
2023-11-24,Penn St.,78,Butler,88,-10
2023-11-30,Texas Tech,95,Butler,103,-8
2023-12-05,Buffalo,59,Butler,72,-13
2023-12-09,California,90,Butler,97,-7
2023-12-15,Saginaw Valley St.,70,Butler,96,-26
2023-12-19,Georgetown,64,Butler,74,-10
2023-11-06,San Francisco St.,57,Cal Baptist,74,-17
2023-11-10,Jackson St.,66,Cal Baptist,80,-14
2023-11-17,Portland St.,66,Cal Baptist,63,3
2023-11-18,St. Thomas,62,Cal Baptist,66,-4
2023-11-19,Cal Poly,58,Cal Baptist,67,-9
2023-11-25,Vanguard,59,Cal Baptist,69,-10
2023-12-06,Utah Tech,72,Cal Baptist,69,3
2023-12-19,Western Kentucky,73,Cal Baptist,70,3
2023-12-27,Chicago St.,62,Cal Baptist,74,-12
2023-11-06,La Verne,62,Cal Poly,80,-18
2023-11-17,St. Thomas,60,Cal Poly,61,-1
2023-11-18,Portland St.,73,Cal Poly,57,16
2023-11-29,San Jose St.,77,Cal Poly,81,-4
2023-12-18,Eastern Washington,62,Cal Poly,53,9
2023-12-21,Nebraska Omaha,53,Cal Poly,66,-13
2023-12-28,Cal St. Northridge,83,Cal Poly,73,10
2023-11-06,Southern Utah,72,Cal St. Bakersfield,73,-1
2023-11-16,Saint Katherine,44,Cal St. Bakersfield,77,-33
2023-12-05,Whittier,58,Cal St. Bakersfield,106,-48
2023-12-19,South Dakota,76,Cal St. Bakersfield,96,-20
2023-12-30,UC Irvine,75,Cal St. Bakersfield,56,19
2023-11-11,La Sierra,48,Cal St. Fullerton,78,-30
2023-11-20,Southern Miss,67,Cal St. Fullerton,74,-7
2023-12-01,North Dakota,54,Cal St. Fullerton,64,-10
2023-12-03,Stanton,52,Cal St. Fullerton,102,-50
2023-12-20,Pacific,56,Cal St. Fullerton,67,-11
2023-12-28,Long Beach St.,81,Cal St. Fullerton,71,10
2023-11-17,Life Pacific,67,Cal St. Northridge,98,-31
2023-11-21,Le Moyne,80,Cal St. Northridge,70,10
2023-11-24,Mississippi Valley St.,48,Cal St. Northridge,84,-36
2023-12-07,Bethesda,54,Cal St. Northridge,92,-38
2023-12-11,Utah Tech,75,Cal St. Northridge,80,-5
2023-12-22,Montana St.,70,Cal St. Northridge,82,-12
2023-11-06,St. Thomas,66,California,71,-5
2023-11-10,Pacific,87,California,79,8
2023-11-13,Cal St. Bakersfield,63,California,83,-20
2023-11-16,Montana St.,63,California,60,3
2023-11-20,UTEP,75,California,72,3
2023-11-22,Tulane,84,California,81,3
2023-12-02,Santa Clara,69,California,84,-15
2023-12-20,UC San Diego,67,California,71,-4
2023-12-29,Arizona,100,California,81,19
2023-12-31,Arizona St.,71,California,69,2
2023-11-06,Navy,48,Campbell,59,-11
2023-11-20,North Carolina Central,78,Campbell,75,3
2023-11-21,Idaho St.,69,Campbell,55,14
2023-11-22,The Citadel,58,Campbell,65,-7
2023-12-02,Southern Virginia,56,Campbell,87,-31
2023-12-12,Pfeiffer,59,Campbell,88,-29
2023-12-14,St. Augustine,48,Campbell,97,-49
2023-12-18,Morgan St.,76,Campbell,83,-7
2023-11-20,D'Youville,69,Canisius,109,-40
2023-12-01,Quinnipiac,73,Canisius,93,-20
2023-12-03,Saint Peter's,54,Canisius,52,2
2023-12-06,Robert Morris,80,Canisius,87,-7
2023-11-10,Hendrix,39,Central Arkansas,82,-43
2023-11-13,Arkansas Pine Bluff,85,Central Arkansas,83,2
2023-11-25,Eastern Michigan,74,Central Arkansas,71,3
2023-11-26,New Orleans,79,Central Arkansas,74,5
2023-12-07,Little Rock,71,Central Arkansas,75,-4
2023-12-20,Western Illinois,65,Central Arkansas,54,11
2023-11-13,Framingham St.,42,Central Connecticut,99,-57
2023-11-19,Manhattan,67,Central Connecticut,63,4
2023-12-02,Holy Cross,67,Central Connecticut,78,-11
2023-12-19,Northeastern,79,Central Connecticut,74,5
2023-12-30,Saint Elizabeth,38,Central Connecticut,99,-61
2023-11-11,Louisiana Monroe,74,Central Michigan,64,10
2023-11-20,Siena,56,Central Michigan,70,-14
2023-12-06,Valparaiso,67,Central Michigan,71,-4
2023-12-19,Davenport,66,Central Michigan,90,-24
2023-12-21,Detroit Mercy,63,Central Michigan,75,-12
2023-11-20,Kansas,83,Chaminade,56,27
2023-11-21,UCLA,76,Chaminade,48,28
2023-11-22,Syracuse,105,Chaminade,56,49
2023-11-06,Iona,69,Charleston,71,-2
2023-11-10,Duquesne,90,Charleston,72,18
2023-12-01,Liberty,67,Charleston,76,-9
2023-12-10,Rhode Island,70,Charleston,85,-15
2023-12-14,The Citadel,71,Charleston,86,-15
2023-12-18,Coastal Carolina,81,Charleston,84,-3
2023-12-21,Saint Joseph's,82,Charleston,89,-7
2023-12-29,Montreat,59,Charleston,96,-37
2023-11-06,Toccoa Falls,59,Charleston Southern,94,-35
2023-11-09,North Florida,81,Charleston Southern,70,11
2023-11-13,Johnson & Wales NC,61,Charleston Southern,102,-41
2023-12-02,South Carolina St.,64,Charleston Southern,66,-2
2023-12-13,North Alabama,76,Charleston Southern,64,12
2023-12-21,Kentucky Christian,79,Charleston Southern,103,-24
2023-11-06,Maine,52,Charlotte,69,-17
2023-11-10,Liberty,71,Charlotte,59,12
2023-11-15,Utah Valley,45,Charlotte,62,-17
2023-11-19,George Mason,49,Charlotte,54,-5
2023-11-25,Georgia St.,57,Charlotte,65,-8
2023-11-29,Davidson,85,Charlotte,81,4
2023-12-05,Stetson,62,Charlotte,85,-23
2023-12-22,Greensboro,44,Charlotte,91,-47
2023-11-06,Covenant,44,Chattanooga,89,-45
2023-11-14,Bellarmine,64,Chattanooga,72,-8
2023-11-19,Tennessee Tech,63,Chattanooga,68,-5
2023-11-24,Evansville,85,Chattanooga,77,8
2023-11-26,Southeast Missouri St.,56,Chattanooga,72,-16
2023-12-10,Tennessee Wesleyan,51,Chattanooga,112,-61
2023-12-19,Gardner Webb,66,Chattanooga,69,-3
2023-11-09,Mercer,66,Chicago St.,61,5
2023-11-14,Cal St. Northridge,74,Chicago St.,64,10
2023-11-22,Morgan St.,83,Chicago St.,84,-1
2023-11-25,Tennessee Martin,94,Chicago St.,71,23
2023-11-30,Delaware St.,76,Chicago St.,69,7
2023-12-03,Stetson,54,Chicago St.,77,-23
2023-12-10,St. Thomas,66,Chicago St.,50,16
2023-12-18,UT Rio Grande Valley,68,Chicago St.,78,-10
2023-12-20,Bethune Cookman,54,Chicago St.,55,-1
2023-11-06,Illinois Chicago,58,Cincinnati,69,-11
2023-11-10,Detroit Mercy,61,Cincinnati,93,-32
2023-11-12,Eastern Washington,73,Cincinnati,85,-12
2023-11-19,Northern Kentucky,66,Cincinnati,90,-24
2023-11-22,Georgia Tech,54,Cincinnati,89,-35
2023-12-03,Florida Gulf Coast,62,Cincinnati,99,-37
2023-12-12,Bryant,53,Cincinnati,85,-32
2023-12-16,Dayton,82,Cincinnati,68,14
2023-12-19,Merrimack,49,Cincinnati,65,-16
2023-12-22,Stetson,75,Cincinnati,83,-8
2023-12-29,Evansville,58,Cincinnati,76,-18
2023-11-06,Winthrop,56,Clemson,78,-22
2023-11-12,Davidson,65,Clemson,68,-3
2023-11-19,Boise St.,68,Clemson,85,-17
2023-11-24,Alcorn St.,69,Clemson,90,-21
2023-12-06,South Carolina,67,Clemson,72,-5
2023-12-09,TCU,66,Clemson,74,-8
2023-12-22,Queens,79,Clemson,109,-30
2023-12-29,Radford,58,Clemson,93,-35
2023-11-08,Defiance,41,Cleveland St.,102,-61
2023-11-11,Ohio,78,Cleveland St.,82,-4
2023-11-15,Canisius,61,Cleveland St.,71,-10
2023-11-22,East Tennessee St.,70,Cleveland St.,72,-2
2023-11-25,Alabama A&M,59,Cleveland St.,86,-27
2023-12-02,Detroit Mercy,58,Cleveland St.,69,-11
2023-12-21,Western Michigan,77,Cleveland St.,90,-13
2023-12-28,Oakland,67,Cleveland St.,75,-8
2023-11-06,Piedmont,86,Coastal Carolina,88,-2
2023-11-16,Wichita St.,86,Coastal Carolina,77,9
2023-11-17,Furman,89,Coastal Carolina,80,9
2023-11-19,Charleston,80,Coastal Carolina,72,8
2023-11-26,North Carolina Central,70,Coastal Carolina,58,12
2023-11-29,USC Upstate,70,Coastal Carolina,72,-2
2023-12-02,Winthrop,90,Coastal Carolina,87,3
2023-12-04,St. Andrews Pres.,46,Coastal Carolina,110,-64
2023-12-09,Wofford,88,Coastal Carolina,80,8
2023-12-21,North Carolina A&T,85,Coastal Carolina,82,3
2023-12-30,Troy,72,Coastal Carolina,65,7
2023-11-06,Brown,70,Colgate,72,-2
2023-11-18,Gardner Webb,52,Colgate,59,-7
2023-11-22,Harvard,76,Colgate,70,6
2023-11-29,Binghamton,49,Colgate,84,-35
2023-12-06,Vermont St.,37,Colgate,115,-78
2023-11-06,Towson,57,Colorado,75,-18
2023-11-10,Grambling St.,63,Colorado,95,-32
2023-11-14,Milwaukee,79,Colorado,106,-27
2023-11-21,Florida St.,77,Colorado,71,6
2023-11-26,Iona,68,Colorado,85,-17
2023-12-03,Pepperdine,66,Colorado,91,-25
2023-12-15,Northern Colorado,68,Colorado,90,-22
2023-12-21,Utah Tech,71,Colorado,98,-27
2023-12-29,Washington,69,Colorado,73,-4
2023-12-31,Washington St.,67,Colorado,74,-7
2023-11-06,Louisiana Tech,73,Colorado St.,81,-8
2023-11-10,Wright St.,77,Colorado St.,105,-28
2023-11-17,UMKC,61,Colorado St.,84,-23
2023-11-22,Boston College,74,Colorado St.,86,-12
2023-11-29,Colorado,83,Colorado St.,88,-5
2023-12-06,Denver,80,Colorado St.,90,-10
2023-12-09,Saint Mary's,64,Colorado St.,61,3
2023-12-17,CSU Pueblo,54,Colorado St.,86,-32
2023-12-29,Adams St.,61,Colorado St.,106,-45
2023-11-11,Albany,78,Columbia,75,3
2023-11-12,Bard,36,Columbia,86,-50
2023-11-15,SUNY Delhi,60,Columbia,105,-45
2023-11-21,LIU,67,Columbia,77,-10
2023-11-25,Maine,56,Columbia,75,-19
2023-11-29,Loyola MD,57,Columbia,69,-12
2023-12-05,Lafayette,72,Columbia,83,-11
2023-11-06,Northern Arizona,52,Connecticut,95,-43
2023-11-11,Stonehill,67,Connecticut,107,-40
2023-11-14,Mississippi Valley St.,53,Connecticut,87,-34
2023-11-24,Manhattan,60,Connecticut,90,-30
2023-11-27,New Hampshire,64,Connecticut,84,-20
2023-12-09,Arkansas Pine Bluff,63,Connecticut,101,-38
2023-12-23,St. John's,65,Connecticut,69,-4
2023-11-09,Towson,70,Coppin St.,49,21
2023-11-30,UMBC,70,Coppin St.,89,-19
2023-12-06,Wagner,62,Coppin St.,59,3
2023-11-08,Morrisville St.,86,Cornell,107,-21
2023-11-19,Cal St. Fullerton,70,Cornell,88,-18
2023-11-20,Utah Valley,61,Cornell,74,-13
2023-11-29,Monmouth,87,Cornell,91,-4
2023-12-30,Colgate,64,Cornell,77,-13
2023-11-07,Florida A&M,54,Creighton,105,-51
2023-11-11,North Dakota St.,60,Creighton,89,-29
2023-11-14,Iowa,84,Creighton,92,-8
2023-11-18,Texas Southern,50,Creighton,82,-32
2023-11-23,Colorado St.,69,Creighton,48,21
2023-12-09,Central Michigan,64,Creighton,109,-45
2023-12-16,Alabama,82,Creighton,85,-3
2023-12-20,Villanova,68,Creighton,66,2
2023-11-10,UMass Lowell,81,Dartmouth,48,33
2023-11-15,Westfield St.,61,Dartmouth,79,-18
2023-12-06,New Hampshire,64,Dartmouth,76,-12
2023-12-09,Marist,63,Dartmouth,53,10
2023-12-13,Boston University,56,Dartmouth,63,-7
2023-12-18,Thomas,48,Dartmouth,77,-29
2023-11-06,Washington & Lee,63,Davidson,86,-23
2023-11-21,Boston University,45,Davidson,69,-24
2023-12-02,Wright St.,73,Davidson,82,-9
2023-12-06,Campbell,50,Davidson,62,-12
2023-12-09,Miami OH,61,Davidson,79,-18
2023-12-16,Lynchburg,63,Davidson,98,-35
2023-12-21,USC Upstate,59,Davidson,62,-3
2023-11-06,SIU Edwardsville,47,Dayton,63,-16
2023-11-17,St. John's,81,Dayton,88,-7
2023-11-24,Youngstown St.,69,Dayton,77,-8
2023-12-02,Grambling St.,46,Dayton,76,-30
2023-12-09,Troy,70,Dayton,82,-12
2023-12-20,Oakland,67,Dayton,91,-24
2023-12-30,Longwood,69,Dayton,78,-9
2023-11-07,Purdue Fort Wayne,82,DePaul,74,8
2023-11-11,Long Beach St.,77,DePaul,73,4
2023-11-14,South Dakota,60,DePaul,72,-12
2023-11-19,San Francisco,70,DePaul,54,16
2023-11-25,Northern Illinois,89,DePaul,79,10
2023-12-01,Iowa St.,99,DePaul,80,19
2023-12-09,Louisville,68,DePaul,75,-7
2023-12-16,Northwestern,56,DePaul,46,10
2023-12-23,Villanova,84,DePaul,48,36
2023-12-30,Chicago St.,58,DePaul,70,-12
2023-11-08,Goldey Beacom,68,Delaware,101,-33
2023-11-12,Air Force,57,Delaware,65,-8
2023-11-24,Brown,59,Delaware,67,-8
2023-11-25,UNC Greensboro,88,Delaware,77,11
2023-12-20,Rider,88,Delaware,85,3
2023-12-30,Princeton,84,Delaware,82,2
2023-11-15,Delaware,78,Delaware St.,67,11
2023-12-05,Gwynedd Mercy,58,Delaware St.,105,-47
2023-12-07,Virginia Lynchburg,73,Delaware St.,106,-33
2023-12-09,Longwood,62,Delaware St.,61,1
2023-12-30,Mount St. Mary's,73,Delaware St.,77,-4
2023-11-09,Cal Poly,76,Denver,97,-21
2023-11-22,Colorado Christian,68,Denver,100,-32
2023-12-02,Colorado College,66,Denver,90,-24
2023-12-18,Adams St.,83,Denver,89,-6
2023-12-20,Northern New Mexico,57,Denver,90,-33
2023-12-31,Oral Roberts,89,Denver,86,3
2023-11-21,Eastern Michigan,76,Detroit Mercy,72,4
2023-11-29,Oakland,65,Detroit Mercy,50,15
2023-12-06,Ball St.,68,Detroit Mercy,65,3
2023-11-08,Lipscomb,70,Drake,85,-15
2023-11-14,SW Minnesota St.,67,Drake,87,-20
2023-11-19,Oakland,77,Drake,85,-8
2023-11-25,Texas Southern,71,Drake,77,-6
2023-12-02,Missouri St.,57,Drake,74,-17
2023-12-06,Saint Louis,69,Drake,75,-6
2023-12-14,Grambling St.,56,Drake,68,-12
2023-12-19,Alcorn St.,55,Drake,92,-37
2023-11-14,Temple,66,Drexel,64,2
2023-11-17,Fairfield,47,Drexel,65,-18
2023-11-19,Queens,52,Drexel,62,-10
2023-12-16,Albany,52,Drexel,71,-19
2023-12-18,Penn State Allegheny,49,Drexel,117,-68
2023-11-06,Dartmouth,54,Duke,92,-38
2023-11-10,Arizona,78,Duke,73,5
2023-11-17,Bucknell,60,Duke,90,-30
2023-11-21,La Salle,66,Duke,95,-29
2023-11-24,Southern Indiana,62,Duke,80,-18
2023-12-09,Charlotte,56,Duke,80,-24
2023-12-12,Hofstra,68,Duke,89,-21
2023-12-20,Baylor,70,Duke,78,-8
2023-12-30,Queens,69,Duke,106,-37
2023-11-06,Cleveland St.,77,Duquesne,79,-2
2023-11-13,Stony Brook,63,Duquesne,85,-22
2023-11-15,Princeton,70,Duquesne,67,3
2023-11-17,Rider,58,Duquesne,77,-19
2023-11-29,UC Irvine,62,Duquesne,66,-4
2023-12-08,Saint Peter's,59,Duquesne,68,-9
2023-12-18,Bradley,67,Duquesne,69,-2
2023-12-30,Cleary,47,Duquesne,95,-48
2023-11-06,Ferrum,61,East Carolina,91,-30
2023-11-11,Campbell,63,East Carolina,77,-14
2023-11-15,USC Upstate,83,East Carolina,81,2
2023-11-19,Northeastern,82,East Carolina,76,6
2023-11-20,Georgia Southern,64,East Carolina,82,-18
2023-11-21,Kennesaw St.,84,East Carolina,85,-1
2023-11-30,UNC Wilmington,66,East Carolina,74,-8
2023-12-04,Maryland Eastern Shore,52,East Carolina,63,-11
2023-12-09,South Carolina,68,East Carolina,62,6
2023-12-20,Delaware St.,50,East Carolina,79,-29
2023-12-29,East Tennessee St.,86,East Carolina,70,16
2023-11-06,King,56,East Tennessee St.,73,-17
2023-11-17,Davidson,68,East Tennessee St.,70,-2
2023-11-24,Alabama A&M,71,East Tennessee St.,82,-11
2023-12-10,Tennessee Tech,72,East Tennessee St.,73,-1
2023-12-15,Tusculum,43,East Tennessee St.,105,-62
2023-12-20,UMKC,57,East Tennessee St.,70,-13
2023-11-08,Monmouth IL,45,Eastern Illinois,91,-46
2023-11-18,Coppin St.,46,Eastern Illinois,48,-2
2023-11-25,Eureka,39,Eastern Illinois,85,-46
2023-12-02,St. Louis Pharmacy,50,Eastern Illinois,112,-62
2023-12-07,IUPUI,58,Eastern Illinois,75,-17
2023-12-10,Central Arkansas,73,Eastern Illinois,70,3
2023-12-17,Blackburn,66,Eastern Illinois,87,-21
2023-11-07,West Virginia Tech,72,Eastern Kentucky,108,-36
2023-11-10,Wilberforce,75,Eastern Kentucky,133,-58
2023-11-17,Tennessee Martin,80,Eastern Kentucky,74,6
2023-11-21,Prairie View A&M,76,Eastern Kentucky,64,12
2023-11-27,Troy,76,Eastern Kentucky,77,-1
2023-12-10,Bethany WV,56,Eastern Kentucky,121,-65
2023-12-17,Northern Kentucky,85,Eastern Kentucky,75,10
2023-11-11,Georgia Southern,60,Eastern Michigan,70,-10
2023-11-18,Cleveland St.,62,Eastern Michigan,69,-7
2023-11-26,North Dakota,72,Eastern Michigan,70,2
2023-12-01,Lake Superior St.,53,Eastern Michigan,68,-15
2023-12-08,Oakland,77,Eastern Michigan,63,14
2023-12-21,Hampton,69,Eastern Michigan,72,-3
2023-12-30,Northwood MI,64,Eastern Michigan,67,-3
2023-11-22,Walla Walla,46,Eastern Washington,97,-51
2023-12-13,Portland Bible,34,Eastern Washington,103,-69
2023-12-28,Portland St.,57,Eastern Washington,91,-34
2023-12-30,Sacramento St.,61,Eastern Washington,87,-26
2023-11-09,East Tennessee St.,76,Elon,79,-3
2023-11-27,Presbyterian,79,Elon,82,-3
2023-11-30,Warren Wilson,56,Elon,127,-71
2023-12-15,Bridgewater VA,70,Elon,104,-34
2023-12-29,Valparaiso,78,Elon,82,-4
2023-11-06,Miami OH,64,Evansville,72,-8
2023-11-09,St. Louis Pharmacy,46,Evansville,116,-70
2023-11-18,Ball St.,50,Evansville,74,-24
2023-12-02,Northern Iowa,89,Evansville,91,-2
2023-12-18,Tennessee Martin,91,Evansville,98,-7
2023-12-20,Tennessee Tech,51,Evansville,82,-31
2023-11-09,Tarleton St.,82,FIU,65,17
2023-11-20,Marshall,80,FIU,69,11
2023-11-21,Loyola Marymount,61,FIU,60,1
2023-11-26,Kennesaw St.,84,FIU,91,-7
2023-11-29,Florida Gulf Coast,68,FIU,65,3
2023-12-02,LIU,59,FIU,74,-15
2023-12-16,Trinity FL,55,FIU,146,-91
2023-12-19,Stetson,80,FIU,68,12
2023-12-21,Maine,74,FIU,82,-8
2023-11-13,Mount Saint Mary,45,Fairfield,92,-47
2023-11-18,Queens,69,Fairfield,63,6
2023-11-24,New Hampshire,83,Fairfield,80,3
2023-12-01,Iona,78,Fairfield,67,11
2023-12-17,Wagner,51,Fairfield,63,-12
2023-12-30,Le Moyne,72,Fairfield,78,-6
2023-11-08,Penn State Brandywine,63,Fairleigh Dickinson,107,-44
2023-11-15,Saint Peter's,70,Fairleigh Dickinson,71,-1
2023-11-18,Penn State Schuylkill,66,Fairleigh Dickinson,124,-58
2023-11-25,Jacksonville,91,Fairleigh Dickinson,90,1
2023-12-11,Columbia,87,Fairleigh Dickinson,83,4
2023-12-21,Fairfield,92,Fairleigh Dickinson,69,23
2023-11-06,Loyola MD,73,Florida,93,-20
2023-11-10,Virginia,73,Florida,70,3
2023-11-14,Florida A&M,68,Florida,89,-21
2023-11-17,Florida St.,68,Florida,89,-21
2023-11-24,Baylor,95,Florida,91,4
2023-12-05,Merrimack,57,Florida,77,-20
2023-12-09,Richmond,76,Florida,87,-11
2023-12-14,East Carolina,65,Florida,70,-5
2023-12-22,Grambling St.,57,Florida,96,-39
2023-12-30,Quinnipiac,72,Florida,97,-25
2023-11-20,Oregon,67,Florida A&M,54,13
2023-11-29,Albany St.,92,Florida A&M,85,7
2023-12-09,LeMoyne Owen,78,Florida A&M,108,-30
2023-11-14,Eastern Michigan,57,Florida Atlantic,100,-43
2023-11-18,Bryant,61,Florida Atlantic,52,9
2023-11-24,Texas A&M,89,Florida Atlantic,96,-7
2023-11-30,Liberty,58,Florida Atlantic,83,-25
2023-12-02,Charleston,74,Florida Atlantic,90,-16
2023-12-13,FIU,60,Florida Atlantic,94,-34
2023-11-10,Ave Maria,71,Florida Gulf Coast,80,-9
2023-11-17,Missouri St.,70,Florida Gulf Coast,61,9
2023-11-18,Hampton,92,Florida Gulf Coast,85,7
2023-11-20,Norfolk St.,69,Florida Gulf Coast,66,3
2023-11-25,UNC Wilmington,71,Florida Gulf Coast,55,16
2023-12-05,New College of Florida,54,Florida Gulf Coast,87,-33
2023-12-22,Florida Memorial,75,Florida Gulf Coast,78,-3
2023-12-30,Florida Atlantic,68,Florida Gulf Coast,72,-4
2023-11-10,Kennesaw St.,67,Florida St.,94,-27
2023-11-13,Central Michigan,67,Florida St.,94,-27
2023-11-29,Georgia,68,Florida St.,66,2
2023-12-16,SMU,68,Florida St.,57,11
2023-12-19,North Florida,75,Florida St.,91,-16
2023-12-22,Winthrop,61,Florida St.,67,-6
2023-12-30,Lipscomb,78,Florida St.,75,3
2023-11-06,Wagner,64,Fordham,68,-4
2023-11-11,Cornell,78,Fordham,73,5
2023-11-17,Norfolk St.,64,Fordham,77,-13
2023-11-27,Manhattan,61,Fordham,93,-32
2023-11-30,Fairleigh Dickinson,52,Fordham,80,-28
2023-12-03,Tulane,89,Fordham,81,8
2023-12-06,NJIT,80,Fordham,77,3
2023-12-10,North Texas,59,Fordham,60,-1
2023-12-21,Central Connecticut,82,Fordham,80,2
2023-12-30,Columbia,78,Fordham,87,-9
2023-11-06,Fresno Pacific,66,Fresno St.,77,-11
2023-11-15,Morgan St.,68,Fresno St.,87,-19
2023-11-22,James Madison,95,Fresno St.,64,31
2023-11-27,UC Santa Barbara,69,Fresno St.,65,4
2023-12-05,Idaho St.,67,Fresno St.,79,-12
2023-12-09,Pacific,56,Fresno St.,89,-33
2023-12-15,Cal St. Bakersfield,58,Fresno St.,61,-3
2023-12-18,Portland St.,75,Fresno St.,72,3
2023-11-06,North Greenville,68,Furman,84,-16
2023-11-10,Belmont,76,Furman,99,-23
2023-11-19,Wyoming,78,Furman,71,7
2023-11-28,South Carolina St.,78,Furman,86,-8
2023-12-09,Bob Jones,58,Furman,100,-42
2023-12-19,Presbyterian,61,Furman,76,-15
2023-12-30,Anderson SC,79,Furman,74,5
2023-11-06,Erskine,58,Gardner Webb,98,-40
2023-11-19,Yale,71,Gardner Webb,70,1
2023-11-25,Limestone,51,Gardner Webb,92,-41
2023-12-02,Western Carolina,77,Gardner Webb,82,-5
2023-12-06,Wofford,81,Gardner Webb,66,15
2023-12-11,North Greenville,60,Gardner Webb,79,-19
2023-12-16,Appalachian St.,80,Gardner Webb,59,21
2023-11-06,Monmouth,61,George Mason,72,-11
2023-11-10,Austin Peay,45,George Mason,67,-22
2023-11-15,Cornell,83,George Mason,90,-7
2023-11-25,East Carolina,59,George Mason,81,-22
2023-11-29,NJIT,68,George Mason,86,-18
2023-12-16,Loyola MD,54,George Mason,62,-8
2023-12-19,Bridgewater VA,60,George Mason,84,-24
2023-12-30,North Carolina A&T,69,George Mason,94,-25
2023-11-06,Stonehill,44,George Washington,89,-45
2023-11-11,William & Mary,89,George Washington,95,-6
2023-11-14,Hofstra,60,George Washington,71,-11
2023-11-18,New Hampshire,67,George Washington,79,-12
2023-11-24,Ohio,94,George Washington,99,-5
2023-11-25,Illinois Chicago,89,George Washington,79,10
2023-11-26,Delaware,71,George Washington,81,-10
2023-12-05,Navy,77,George Washington,79,-2
2023-12-09,Coppin St.,45,George Washington,76,-31
2023-12-12,Bowie St.,73,George Washington,88,-15
2023-12-21,Alcorn St.,75,George Washington,79,-4
2023-12-30,Maryland Eastern Shore,63,George Washington,69,-6
2023-11-07,Le Moyne,57,Georgetown,94,-37
2023-11-11,Holy Cross,68,Georgetown,67,1
2023-11-18,Mount St. Mary's,72,Georgetown,83,-11
2023-11-19,American,83,Georgetown,88,-5
2023-11-25,Jackson St.,81,Georgetown,88,-7
2023-11-29,Merrimack,67,Georgetown,69,-2
2023-12-02,TCU,84,Georgetown,83,1
2023-12-09,Syracuse,80,Georgetown,68,12
2023-12-12,Coppin St.,54,Georgetown,71,-17
2023-11-10,Wake Forest,77,Georgia,80,-3
2023-11-12,North Carolina Central,54,Georgia,64,-10
2023-11-17,Miami FL,79,Georgia,68,11
2023-11-24,Winthrop,69,Georgia,78,-9
2023-12-01,Mercer,69,Georgia,80,-11
2023-12-05,Georgia Tech,62,Georgia,76,-14
2023-12-16,High Point,58,Georgia,66,-8
2023-12-20,Mount St. Mary's,82,Georgia,94,-12
2023-12-22,North Florida,60,Georgia,78,-18
2023-12-30,Alabama A&M,73,Georgia,93,-20
2023-12-02,Jacksonville,81,Georgia Southern,79,2
2023-12-16,UNC Wilmington,82,Georgia Southern,77,5
2023-12-19,Florida Gulf Coast,53,Georgia Southern,42,11
2023-12-30,Southern Miss,67,Georgia Southern,88,-21
2023-11-17,Northern Illinois,70,Georgia St.,64,6
2023-11-19,Little Rock,77,Georgia St.,88,-11
2023-12-04,Middle Georgia St.,57,Georgia St.,89,-32
2023-12-19,Toccoa Falls,45,Georgia St.,122,-77
2023-12-30,Arkansas St.,90,Georgia St.,91,-1
2023-11-06,Georgia Southern,62,Georgia Tech,84,-22
2023-11-09,Howard,85,Georgia Tech,88,-3
2023-11-14,UMass Lowell,74,Georgia Tech,71,3
2023-11-28,Mississippi St.,59,Georgia Tech,67,-8
2023-12-02,Duke,68,Georgia Tech,72,-4
2023-12-09,Alabama A&M,49,Georgia Tech,70,-21
2023-12-24,Nevada,72,Georgia Tech,64,8
2023-11-10,Yale,71,Gonzaga,86,-15
2023-11-14,Eastern Oregon,57,Gonzaga,123,-66
2023-11-20,Purdue,73,Gonzaga,63,10
2023-11-21,Syracuse,57,Gonzaga,76,-19
2023-11-28,Cal St. Bakersfield,65,Gonzaga,81,-16
2023-12-05,Arkansas Pine Bluff,71,Gonzaga,111,-40
2023-12-11,Mississippi Valley St.,40,Gonzaga,78,-38
2023-12-15,Connecticut,76,Gonzaga,63,13
2023-12-20,Jackson St.,76,Gonzaga,100,-24
2023-12-29,San Diego St.,84,Gonzaga,74,10
2023-11-06,UNT Dallas,67,Grambling St.,82,-15
2023-11-14,Champion Christian,73,Grambling St.,113,-40
2023-11-17,Delaware St.,71,Grambling St.,63,8
2023-11-06,Southeast Missouri St.,67,Grand Canyon,88,-21
2023-11-12,Northern Arizona,55,Grand Canyon,89,-34
2023-11-17,San Francisco,72,Grand Canyon,76,-4
2023-11-19,South Carolina,75,Grand Canyon,68,7
2023-11-25,North Dakota St.,71,Grand Canyon,86,-15
2023-12-02,UT Arlington,69,Grand Canyon,76,-7
2023-12-05,San Diego St.,73,Grand Canyon,79,-6
2023-12-16,Portland,63,Grand Canyon,91,-28
2023-12-20,Sam Houston St.,64,Grand Canyon,76,-12
2023-12-27,Bethesda,74,Grand Canyon,124,-50
2023-12-30,Louisiana Tech,70,Grand Canyon,73,-3
2023-11-09,St. Francis IL,56,Green Bay,72,-16
2023-11-21,UC Riverside,74,Green Bay,68,6
2023-11-25,St. Thomas,51,Green Bay,64,-13
2023-12-02,Milwaukee,58,Green Bay,70,-12
2023-12-09,Western Illinois,68,Green Bay,59,9
2023-12-21,MSOE,46,Green Bay,79,-33
2023-12-29,Wright St.,77,Green Bay,88,-11
2023-12-31,Robert Morris,61,Green Bay,78,-17
2023-11-09,Mid Atlantic Christian,46,Hampton,109,-63
2023-11-20,San Jose St.,71,Hampton,52,19
2023-11-27,UMBC,80,Hampton,76,4
2023-12-03,Virginia Lynchburg,66,Hampton,121,-55
2023-12-11,Mary Baldwin,53,Hampton,100,-47
2023-12-16,James Madison,88,Hampton,71,17
2023-11-06,UMass Boston,50,Harvard,78,-28
2023-11-14,Northeastern,56,Harvard,80,-24
2023-11-29,American,75,Harvard,80,-5
2023-12-08,Army,64,Harvard,70,-6
2023-12-21,Holy Cross,72,Harvard,74,-2
2023-12-30,Iona,69,Harvard,60,9
2023-11-14,Hawaii Hilo,66,Hawaii,82,-16
2023-11-16,Niagara,73,Hawaii,92,-19
2023-11-21,Northern Arizona,61,Hawaii,70,-9
2023-11-24,UT Rio Grande Valley,57,Hawaii,76,-19
2023-12-03,Central Arkansas,76,Hawaii,95,-19
2023-12-10,Hawaii Pacific,53,Hawaii,78,-25
2023-12-17,Nevada,72,Hawaii,66,6
2023-12-21,Portland,56,Hawaii,69,-13
2023-12-22,Georgia Tech,73,Hawaii,68,5
2023-12-24,TCU,65,Hawaii,51,14
2023-12-30,Cal St. Fullerton,63,Hawaii,61,2
2023-11-06,St. Andrews Pres.,51,High Point,105,-54
2023-11-20,Iona,68,High Point,82,-14
2023-11-26,Mount Olive,73,High Point,122,-49
2023-11-29,Morgan St.,59,High Point,77,-18
2023-12-05,Western Carolina,71,High Point,97,-26
2023-12-08,North Carolina A&T,62,High Point,75,-13
2023-12-19,UNC Greensboro,63,High Point,74,-11
2023-12-22,Canisius,70,High Point,78,-8
2023-12-30,Bellarmine,85,High Point,90,-5
2023-11-06,St. Joseph's NY,48,Hofstra,101,-53
2023-11-10,Princeton,74,Hofstra,67,7
2023-11-21,Wright St.,76,Hofstra,85,-9
2023-11-22,High Point,92,Hofstra,97,-5
2023-11-30,South Florida,63,Hofstra,82,-19
2023-12-16,Norfolk St.,58,Hofstra,74,-16
2023-11-14,Sacred Heart,84,Holy Cross,77,7
2023-11-18,Elon,83,Holy Cross,69,14
2023-11-29,Maine,72,Holy Cross,57,15
2023-12-18,Quinnipiac,77,Holy Cross,57,20
2023-12-29,Elms,60,Holy Cross,88,-28
2023-11-06,Louisiana Monroe,31,Houston,84,-53
2023-11-11,Texas A&M Corpus Chris,50,Houston,82,-32
2023-11-13,Stetson,48,Houston,79,-31
2023-11-19,Dayton,55,Houston,69,-14
2023-11-24,Montana,44,Houston,79,-35
2023-12-06,Rice,39,Houston,75,-36
2023-12-09,Jackson St.,55,Houston,89,-34
2023-12-16,Texas A&M,66,Houston,70,-4
2023-12-21,Texas St.,37,Houston,72,-35
2023-12-30,Penn,42,Houston,81,-39
2023-11-15,FIU,83,Houston Christian,74,9
2023-11-20,UTSA,89,Houston Christian,87,2
2023-12-06,Southwestern Adventist,58,Houston Christian,95,-37
2023-12-16,Champion Christian,72,Houston Christian,107,-35
2023-11-06,Hampton,80,Howard,92,-12
2023-11-14,Boston University,53,Howard,64,-11
2023-11-28,Cincinnati,86,Howard,81,5
2023-12-13,Regent,49,Howard,88,-39
2023-11-06,Spalding,63,IUPUI,70,-7
2023-11-17,Elon,86,IUPUI,72,14
2023-11-19,Holy Cross,74,IUPUI,61,13
2023-11-25,Cleary,70,IUPUI,78,-8
2023-12-02,Northern Kentucky,71,IUPUI,55,16
2023-12-16,Lindenwood,73,IUPUI,67,6
2023-12-21,Defiance,67,IUPUI,90,-23
2023-12-29,Detroit Mercy,55,IUPUI,67,-12
2023-12-31,Cleveland St.,86,IUPUI,77,9
2023-11-09,Cal St. Northridge,76,Idaho,73,3
2023-11-14,Evergreen St.,42,Idaho,88,-46
2023-11-17,Pacific Lutheran,52,Idaho,96,-44
2023-11-24,UC San Diego,70,Idaho,73,-3
2023-11-29,Denver,67,Idaho,65,2
2023-12-02,Cal Poly,70,Idaho,85,-15
2023-12-05,Pacific,53,Idaho,83,-30
2023-12-28,Sacramento St.,58,Idaho,61,-3
2023-12-30,Portland St.,77,Idaho,72,5
2023-11-06,Warner Pacific,36,Idaho St.,92,-56
2023-11-16,Northwest,51,Idaho St.,85,-34
2023-11-20,The Citadel,62,Idaho St.,61,1
2023-12-02,Lindenwood,70,Idaho St.,76,-6
2023-12-28,Montana St.,74,Idaho St.,66,8
2023-12-30,Montana,76,Idaho St.,68,8
2023-11-06,Eastern Illinois,52,Illinois,80,-28
2023-11-10,Oakland,53,Illinois,64,-11
2023-11-14,Marquette,71,Illinois,64,7
2023-11-17,Valparaiso,64,Illinois,87,-23
2023-11-19,Southern,60,Illinois,88,-28
2023-11-24,Western Illinois,52,Illinois,84,-32
2023-12-05,Florida Atlantic,89,Illinois,98,-9
2023-12-17,Colgate,57,Illinois,74,-17
2023-12-29,Fairleigh Dickinson,71,Illinois,104,-33
2023-11-10,Little Rock,71,Illinois Chicago,86,-15
2023-11-19,Aurora,48,Illinois Chicago,99,-51
2023-11-24,Middle Tennessee,40,Illinois Chicago,70,-30
2023-11-26,UNC Greensboro,58,Illinois Chicago,57,1
2023-11-30,Illinois St.,69,Illinois Chicago,64,5
2023-12-12,Green Bay,70,Illinois Chicago,68,2
2023-12-16,Western Michigan,68,Illinois Chicago,89,-21
2023-12-21,Incarnate Word,67,Illinois Chicago,66,1
2023-11-06,Lourdes,56,Illinois St.,75,-19
2023-11-15,Eastern Illinois,61,Illinois St.,69,-8
2023-11-20,Long Beach St.,52,Illinois St.,61,-9
2023-11-21,High Point,74,Illinois St.,72,2
2023-12-03,Murray St.,72,Illinois St.,76,-4
2023-12-06,Northern Kentucky,59,Illinois St.,62,-3
2023-12-09,Norfolk St.,64,Illinois St.,58,6
2023-12-17,North Dakota St.,65,Illinois St.,75,-10
2023-12-21,Southeast Missouri St.,64,Illinois St.,85,-21
2023-11-14,Schreiner,63,Incarnate Word,104,-41
2023-11-22,Jacksonville St.,66,Incarnate Word,67,-1
2023-12-09,Northern Arizona,76,Incarnate Word,75,1
2023-11-07,Florida Gulf Coast,63,Indiana,69,-6
2023-11-12,Army,64,Indiana,72,-8
2023-11-16,Wright St.,80,Indiana,89,-9
2023-11-19,Connecticut,77,Indiana,57,20
2023-11-26,Harvard,76,Indiana,89,-13
2023-12-01,Maryland,53,Indiana,65,-12
2023-12-16,Kansas,75,Indiana,71,4
2023-12-19,Morehead St.,68,Indiana,69,-1
2023-12-21,North Alabama,66,Indiana,83,-17
2023-12-29,Kennesaw St.,87,Indiana,100,-13
2023-11-06,St. Mary of the Woods,60,Indiana St.,90,-30
2023-11-14,IUPUI,57,Indiana St.,96,-39
2023-11-21,Rice,88,Indiana St.,103,-15
2023-11-24,Toledo,74,Indiana St.,76,-2
2023-11-28,Southern Illinois,48,Indiana St.,77,-29
2023-12-09,Southern Indiana,54,Indiana St.,98,-44
2023-12-19,Tennessee St.,69,Indiana St.,90,-21
2023-11-10,Sacred Heart,81,Iona,88,-7
2023-11-29,Marist,68,Iona,64,4
2023-12-06,Hofstra,62,Iona,57,5
2023-12-10,Saint Francis,54,Iona,61,-7
2023-12-21,Colgate,65,Iona,85,-20
2023-11-07,North Dakota,68,Iowa,110,-42
2023-11-10,Alabama St.,67,Iowa,98,-31
2023-11-17,Arkansas St.,74,Iowa,88,-14
2023-11-23,Oklahoma,79,Iowa,67,12
2023-11-29,North Florida,78,Iowa,103,-25
2023-12-10,Michigan,90,Iowa,80,10
2023-12-16,Florida A&M,52,Iowa,88,-36
2023-12-20,UMBC,81,Iowa,103,-22
2023-12-29,Northern Illinois,74,Iowa,103,-29
2023-11-06,Green Bay,44,Iowa St.,85,-41
2023-11-09,Lindenwood,47,Iowa St.,102,-55
2023-11-12,Idaho St.,55,Iowa St.,86,-31
2023-11-19,Grambling St.,37,Iowa St.,92,-55
2023-11-26,Texas A&M,73,Iowa St.,69,4
2023-12-07,Iowa,65,Iowa St.,90,-25
2023-12-10,Prairie View A&M,56,Iowa St.,107,-51
2023-12-17,Florida A&M,58,Iowa St.,96,-38
2023-12-21,Eastern Illinois,48,Iowa St.,80,-32
2023-12-31,New Hampshire,70,Iowa St.,85,-15
2023-12-16,Howard,74,Jackson St.,81,-7
2023-12-17,North Carolina A&T,60,Jackson St.,68,-8
2023-11-06,Johnson FL,46,Jacksonville,113,-67
2023-11-14,Georgia Southern,68,Jacksonville,85,-17
2023-11-29,Campbell,48,Jacksonville,62,-14
2023-12-14,Trinity Baptist,54,Jacksonville,91,-37
2023-12-18,Louisiana Monroe,65,Jacksonville,75,-10
2023-12-30,Erskine,52,Jacksonville,79,-27
2023-11-07,Brescia,41,Jacksonville St.,91,-50
2023-11-11,Utah Tech,81,Jacksonville St.,79,2
2023-11-26,Incarnate Word,65,Jacksonville St.,67,-2
2023-11-30,South Alabama,52,Jacksonville St.,70,-18
2023-12-03,East Tennessee St.,61,Jacksonville St.,59,2
2023-12-08,Illinois Chicago,55,Jacksonville St.,49,6
2023-12-28,Fort Valley St.,57,Jacksonville St.,93,-36
2023-12-31,Trevecca Nazarene,67,Jacksonville St.,107,-40
2023-11-12,Howard,86,James Madison,107,-21
2023-11-17,Radford,73,James Madison,76,-3
2023-11-29,Buffalo,66,James Madison,81,-15
2023-12-03,Keystone,59,James Madison,130,-71
2023-12-19,Coppin St.,48,James Madison,87,-39
2023-12-30,Texas St.,65,James Madison,82,-17
2023-11-06,North Carolina Central,56,Kansas,99,-43
2023-11-10,Manhattan,61,Kansas,99,-38
2023-11-22,Tennessee,60,Kansas,69,-9
2023-11-28,Eastern Illinois,63,Kansas,71,-8
2023-12-01,Connecticut,65,Kansas,69,-4
2023-12-05,UMKC,69,Kansas,88,-19
2023-12-09,Missouri,64,Kansas,73,-9
2023-12-22,Yale,60,Kansas,75,-15
2023-12-30,Wichita St.,67,Kansas,86,-19
2023-11-06,USC,82,Kansas St.,69,13
2023-11-10,Bellarmine,75,Kansas St.,83,-8
2023-11-13,South Dakota St.,68,Kansas St.,91,-23
2023-11-19,Miami FL,91,Kansas St.,83,8
2023-11-22,Central Arkansas,56,Kansas St.,100,-44
2023-11-28,Oral Roberts,78,Kansas St.,88,-10
2023-12-02,North Alabama,74,Kansas St.,75,-1
2023-12-05,Villanova,71,Kansas St.,72,-1
2023-12-17,Nebraska,62,Kansas St.,46,16
2023-12-21,Wichita St.,60,Kansas St.,69,-9
2023-11-07,Oakwood,46,Kennesaw St.,93,-47
2023-11-15,Keiser,55,Kennesaw St.,101,-46
2023-11-19,Georgia Southern,92,Kennesaw St.,96,-4
2023-12-02,Georgia St.,77,Kennesaw St.,88,-11
2023-12-05,UNC Asheville,76,Kennesaw St.,79,-3
2023-12-19,Brescia,59,Kennesaw St.,91,-32
2023-11-06,Malone,58,Kent St.,79,-21
2023-11-09,James Madison,113,Kent St.,108,5
2023-11-11,Fresno St.,69,Kent St.,79,-10
2023-11-17,Hampton,62,Kent St.,100,-38
2023-11-20,Fordham,72,Kent St.,79,-7
2023-11-26,Charleston,84,Kent St.,78,6
2023-11-30,Shawnee St.,61,Kent St.,103,-42
2023-12-09,Cleveland St.,77,Kent St.,83,-6
2023-11-06,New Mexico St.,46,Kentucky,86,-40
2023-11-10,Texas A&M Commerce,61,Kentucky,81,-20
2023-11-14,Kansas,89,Kentucky,84,5
2023-11-17,Stonehill,67,Kentucky,101,-34
2023-11-20,Saint Joseph's,88,Kentucky,96,-8
2023-11-24,Marshall,82,Kentucky,118,-36
2023-11-28,Miami FL,73,Kentucky,95,-22
2023-12-02,UNC Wilmington,80,Kentucky,73,7
2023-12-29,Illinois St.,70,Kentucky,96,-26
2023-11-10,Air Force,82,LIU,67,15
2023-11-24,Texas A&M Corpus Chris,68,LIU,83,-15
2023-12-28,Albany,86,LIU,69,17
2023-11-06,Mississippi Valley St.,60,LSU,106,-46
2023-11-10,Nicholls St.,68,LSU,66,2
2023-11-16,Dayton,70,LSU,67,3
2023-11-17,North Texas,62,LSU,66,-4
2023-11-24,North Florida,63,LSU,75,-12
2023-12-01,Southeastern Louisiana,66,LSU,73,-7
2023-12-09,Kansas St.,75,LSU,60,15
2023-12-13,Alabama St.,56,LSU,74,-18
2023-12-21,Lamar,66,LSU,87,-21
2023-12-29,Northwestern St.,55,LSU,96,-41
2023-11-07,Drexel,61,La Salle,67,-6
2023-11-11,Northeastern,74,La Salle,79,-5
2023-11-14,Bucknell,57,La Salle,69,-12
2023-11-18,Southern Indiana,78,La Salle,79,-1
2023-11-26,Coppin St.,62,La Salle,81,-19
2023-12-06,Loyola MD,61,La Salle,62,-1
2023-12-21,Rosemont,41,La Salle,107,-66
2023-12-30,Howard,71,La Salle,66,5
2023-11-19,Wilkes,53,Lafayette,69,-16
2023-11-26,Belmont,79,Lafayette,69,10
2023-11-29,Drexel,69,Lafayette,48,21
2023-12-02,Cornell,79,Lafayette,71,8
2023-12-09,La Salle,67,Lafayette,51,16
2023-12-21,Quinnipiac,78,Lafayette,60,18
2023-11-18,Utah Tech,81,Lake Erie,69,12
2023-11-06,Jarvis Christian,66,Lamar,114,-48
2023-11-14,UTSA,82,Lamar,90,-8
2023-11-24,Bethune Cookman,65,Lamar,83,-18
2023-11-26,Delaware St.,81,Lamar,84,-3
2023-12-14,Louisiana Monroe,73,Lamar,97,-24
2023-12-18,Southern Miss,82,Lamar,79,3
2023-12-30,Paul Quinn,64,Lamar,91,-27
2023-11-13,SUNY Canton,46,Le Moyne,105,-59
2023-11-29,Fredonia St.,54,Le Moyne,92,-38
2023-12-16,Dartmouth,54,Le Moyne,80,-26
2023-12-18,Houghton,72,Le Moyne,92,-20
2023-11-06,Cornell,84,Lehigh,78,6
2023-11-16,SUNY Oneonta,65,Lehigh,90,-25
2023-11-29,Saint Francis,62,Lehigh,61,1
2023-12-09,Cairn,33,Lehigh,88,-55
2023-11-06,Mid Atlantic Christian,43,Liberty,103,-60
2023-11-16,Furman,74,Liberty,88,-14
2023-11-17,Wichita St.,66,Liberty,83,-17
2023-11-19,Vermont,61,Liberty,71,-10
2023-11-25,Maryland Eastern Shore,62,Liberty,99,-37
2023-12-05,Mississippi Valley St.,39,Liberty,74,-35
2023-12-09,Grand Canyon,69,Liberty,64,5
2023-12-13,Tennessee St.,52,Liberty,74,-22
2023-12-16,St. Andrews Pres.,26,Liberty,99,-73
2023-11-13,Hannibal LaGrange,52,Lindenwood,83,-31
2023-11-17,Nebraska Omaha,70,Lindenwood,72,-2
2023-11-27,Utah Tech,73,Lindenwood,66,7
2023-12-09,UMKC,72,Lindenwood,67,5
2023-12-12,Avila,64,Lindenwood,81,-17
2023-12-22,Rockford,54,Lindenwood,81,-27
2023-12-31,Southern Indiana,73,Lindenwood,62,11
2023-11-11,Asbury,74,Lipscomb,113,-39
2023-11-18,Alabama A&M,81,Lipscomb,106,-25
2023-11-24,UNC Asheville,75,Lipscomb,86,-11
2023-11-29,Chattanooga,68,Lipscomb,82,-14
2023-12-10,Tennessee St.,71,Lipscomb,78,-7
2023-12-20,Bryan,55,Lipscomb,101,-46
2023-11-06,Texas St.,66,Little Rock,71,-5
2023-11-18,Northern Illinois,98,Little Rock,93,5
2023-11-22,Georgia St.,93,Little Rock,90,3
2023-11-25,Tulsa,82,Little Rock,84,-2
2023-11-28,Ball St.,64,Little Rock,90,-26
2023-12-01,Arkansas St.,66,Little Rock,77,-11
2023-12-10,Winthrop,85,Little Rock,68,17
2023-12-13,UTSA,84,Little Rock,93,-9
2023-12-18,Murray St.,66,Little Rock,80,-14
2023-12-21,Jacksonville St.,90,Little Rock,60,30
2023-11-21,Iona,76,Long Beach St.,80,-4
2023-12-02,Sacramento St.,73,Long Beach St.,83,-10
2023-12-06,Life Pacific,66,Long Beach St.,88,-22
2023-12-19,Cal St.Dominguez Hills,78,Long Beach St.,107,-29
2023-12-30,Cal St. Northridge,84,Long Beach St.,68,16
2023-11-11,St. Mary's MD,43,Longwood,95,-52
2023-11-18,North Carolina Central,66,Longwood,73,-7
2023-11-24,Delaware St.,82,Longwood,84,-2
2023-11-25,Lamar,72,Longwood,83,-11
2023-11-26,Bethune Cookman,48,Longwood,69,-21
2023-11-30,The Apprentice School,46,Longwood,95,-49
2023-12-11,Gallaudet,61,Longwood,92,-31
2023-12-17,VMI,49,Longwood,68,-19
2023-11-06,Youngstown St.,62,Louisiana,72,-10
2023-11-15,Louisiana Christian,56,Louisiana,107,-51
2023-11-22,Long Beach St.,82,Louisiana,92,-10
2023-11-27,Loyola LA,54,Louisiana,78,-24
2023-12-13,Eastern Kentucky,62,Louisiana,73,-11
2023-11-16,Louisiana Tech,73,Louisiana Monroe,63,10
2023-11-20,Ecclesia,74,Louisiana Monroe,103,-29
2023-11-28,Northwestern St.,70,Louisiana Monroe,74,-4
2023-12-05,Champion Christian,63,Louisiana Monroe,110,-47
2023-11-13,Lyon,43,Louisiana Tech,100,-57
2023-11-21,Southern Utah,53,Louisiana Tech,67,-14
2023-11-22,McNeese St.,62,Louisiana Tech,71,-9
2023-11-25,Dillard,65,Louisiana Tech,105,-40
2023-12-02,Nicholls St.,55,Louisiana Tech,68,-13
2023-12-09,Louisiana,67,Louisiana Tech,72,-5
2023-12-12,Southeastern Louisiana,60,Louisiana Tech,89,-29
2023-11-06,UMBC,93,Louisville,94,-1
2023-11-10,Chattanooga,81,Louisville,71,10
2023-11-15,Coppin St.,41,Louisville,61,-20
2023-11-19,Texas,81,Louisville,80,1
2023-11-20,Indiana,74,Louisville,66,8
2023-11-26,New Mexico St.,84,Louisville,90,-6
2023-11-29,Bellarmine,68,Louisville,73,-5
2023-12-13,Arkansas St.,75,Louisville,63,12
2023-12-17,Pepperdine,63,Louisville,85,-22
2023-12-21,Kentucky,95,Louisville,76,19
2023-11-08,Florida Atlantic,75,Loyola Chicago,62,13
2023-11-11,Eastern Illinois,65,Loyola Chicago,89,-24
2023-11-14,Illinois Chicago,72,Loyola Chicago,67,5
2023-11-18,New Orleans,70,Loyola Chicago,73,-3
2023-11-22,Creighton,88,Loyola Chicago,65,23
2023-11-23,Boston College,68,Loyola Chicago,71,-3
2023-11-28,Chicago St.,53,Loyola Chicago,62,-9
2023-12-02,Harvard,53,Loyola Chicago,75,-22
2023-12-09,Goshen,64,Loyola Chicago,115,-51
2023-12-19,Charleston Southern,59,Loyola Chicago,72,-13
2023-12-30,Central Michigan,35,Loyola Chicago,73,-38
2023-11-15,Binghamton,63,Loyola MD,57,6
2023-11-18,Sacred Heart,66,Loyola MD,51,15
2023-12-02,Delaware St.,79,Loyola MD,73,6
2023-12-09,Mount St. Mary's,77,Loyola MD,64,13
2023-12-22,St. Mary's MD,57,Loyola MD,91,-34
2023-11-07,Westcliff,68,Loyola Marymount,109,-41
2023-11-12,Yale,83,Loyola Marymount,80,3
2023-11-14,Jackson St.,66,Loyola Marymount,88,-22
2023-11-19,Stephen F. Austin,86,Loyola Marymount,76,10
2023-11-20,Oakland,74,Loyola Marymount,69,5
2023-11-25,UTEP,47,Loyola Marymount,67,-20
2023-11-29,Central Arkansas,63,Loyola Marymount,90,-27
2023-12-16,UC Santa Barbara,68,Loyola Marymount,59,9
2023-12-18,Detroit Mercy,56,Loyola Marymount,76,-20
2023-12-22,Colorado St.,76,Loyola Marymount,67,9
2023-12-29,Tarleton St.,79,Loyola Marymount,66,13
2023-11-08,Maine Presque Isle,59,Maine,111,-52
2023-11-12,Merrimack,71,Maine,65,6
2023-11-17,Presbyterian,66,Maine,80,-14
2023-12-03,Brown,49,Maine,60,-11
2023-12-09,Central Connecticut,56,Maine,69,-13
2023-11-16,Felician,67,Manhattan,79,-12
2023-12-01,Mount St. Mary's,74,Manhattan,75,-1
2023-12-08,Fairleigh Dickinson,76,Manhattan,71,5
2023-12-30,Wagner,68,Manhattan,56,12
2023-11-25,Bucknell,49,Marist,73,-24
2023-12-03,Manhattan,56,Marist,70,-14
2023-12-18,Maryland Eastern Shore,52,Marist,76,-24
2023-12-30,Lehigh,65,Marist,58,7
2023-11-06,Northern Illinois,70,Marquette,92,-22
2023-11-10,Rider,65,Marquette,95,-30
2023-11-20,UCLA,69,Marquette,71,-2
2023-11-21,Kansas,59,Marquette,73,-14
2023-11-22,Purdue,78,Marquette,75,3
2023-11-28,Southern,56,Marquette,93,-37
2023-12-06,Texas,65,Marquette,86,-21
2023-12-09,Notre Dame,59,Marquette,78,-19
2023-12-14,St. Thomas,79,Marquette,84,-5
2023-12-22,Georgetown,51,Marquette,81,-30
2023-12-30,Creighton,67,Marquette,72,-5
2023-11-06,Queens,73,Marshall,89,-16
2023-11-10,Radford,66,Marshall,62,4
2023-11-21,Oakland,78,Marshall,71,7
2023-12-02,Miami OH,79,Marshall,74,5
2023-12-06,Duquesne,85,Marshall,72,13
2023-12-16,UNC Greensboro,65,Marshall,72,-7
2023-12-18,Bluefield,70,Marshall,103,-33
2023-12-21,UNC Wilmington,78,Marshall,69,9
2023-12-30,Louisiana,61,Marshall,75,-14
2023-11-07,Mount St. Mary's,53,Maryland,68,-15
2023-11-10,Davidson,64,Maryland,61,3
2023-11-21,UMBC,68,Maryland,92,-24
2023-11-25,South Alabama,55,Maryland,68,-13
2023-11-28,Rider,76,Maryland,103,-27
2023-12-06,Penn St.,75,Maryland,81,-6
2023-12-12,Alcorn St.,65,Maryland,105,-40
2023-12-19,Nicholls St.,67,Maryland,73,-6
2023-12-28,Coppin St.,53,Maryland,75,-22
2023-11-11,Cairn,65,Maryland Eastern Shore,83,-18
2023-11-15,Longwood,80,Maryland Eastern Shore,61,19
2023-11-18,Penn,80,Maryland Eastern Shore,83,-3
2023-11-07,Albany,71,Massachusetts,92,-21
2023-11-13,Quinnipiac,81,Massachusetts,102,-21
2023-11-17,Harvard,78,Massachusetts,75,3
2023-11-22,Central Connecticut,60,Massachusetts,89,-29
2023-12-02,South Florida,56,Massachusetts,66,-10
2023-12-09,UMass Lowell,77,Massachusetts,91,-14
2023-12-16,West Virginia,79,Massachusetts,87,-8
2023-12-21,Georgia Tech,73,Massachusetts,70,3
2023-12-24,Old Dominion,65,Massachusetts,87,-22
2023-12-30,Siena,66,Massachusetts,79,-13
2023-11-10,Biblical Studies,55,McNeese St.,96,-41
2023-11-13,Champion Christian,46,McNeese St.,110,-64
2023-11-14,LeTourneau,49,McNeese St.,81,-32
2023-11-21,Texas St.,48,McNeese St.,59,-11
2023-12-02,Tennessee Martin,80,McNeese St.,91,-11
2023-12-05,Miss. Univ. for Women,23,McNeese St.,92,-69
2023-12-13,Southern Miss,48,McNeese St.,67,-19
2023-12-17,Louisiana,72,McNeese St.,74,-2
2023-11-06,Jackson St.,77,Memphis,94,-17
2023-11-17,Alabama St.,75,Memphis,92,-17
2023-11-22,Michigan,67,Memphis,71,-4
2023-11-24,Villanova,79,Memphis,63,16
2023-12-16,Clemson,77,Memphis,79,-2
2023-12-19,Virginia,54,Memphis,77,-23
2023-12-23,Vanderbilt,75,Memphis,77,-2
2023-12-30,Austin Peay,70,Memphis,81,-11
2023-11-06,Clark Atlanta,71,Mercer,64,7
2023-12-06,South Alabama,83,Mercer,62,21
2023-12-09,Georgia St.,60,Mercer,64,-4
2023-12-16,Florida Gulf Coast,65,Mercer,70,-5
2023-12-19,Queens,65,Mercer,84,-19
2023-12-21,Thomas,75,Mercer,98,-23
2023-12-29,Talladega,50,Mercer,74,-24
2023-11-09,Worcester St.,72,Merrimack,93,-21
2023-11-22,North Carolina A&T,73,Merrimack,96,-23
2023-11-25,Alabama St.,66,Merrimack,60,6
2023-12-02,UMass Lowell,68,Merrimack,74,-6
2023-12-09,Felician,85,Merrimack,89,-4
2023-12-22,Bucknell,52,Merrimack,68,-16
2023-11-06,NJIT,60,Miami FL,101,-41
2023-11-10,UCF,72,Miami FL,88,-16
2023-11-13,FIU,80,Miami FL,86,-6
2023-12-02,Notre Dame,49,Miami FL,62,-13
2023-12-06,LIU,49,Miami FL,97,-48
2023-12-10,Colorado,90,Miami FL,63,27
2023-12-16,La Salle,77,Miami FL,84,-7
2023-12-21,Stonehill,59,Miami FL,97,-38
2023-12-29,North Florida,55,Miami FL,95,-40
2023-11-11,Texas St.,75,Miami OH,65,10
2023-11-17,Coppin St.,48,Miami OH,76,-28
2023-11-19,Eastern Illinois,64,Miami OH,76,-12
2023-11-28,Spalding,43,Miami OH,82,-39
2023-12-22,Vermont,69,Miami OH,70,-1
2023-12-29,Wilberforce,69,Miami OH,119,-50
2023-11-07,UNC Asheville,74,Michigan,99,-25
2023-11-10,Youngstown St.,62,Michigan,92,-30
2023-11-17,Long Beach St.,94,Michigan,86,8
2023-11-24,Texas Tech,73,Michigan,57,16
2023-12-05,Indiana,78,Michigan,75,3
2023-12-16,Eastern Michigan,66,Michigan,83,-17
2023-12-19,Florida,106,Michigan,101,5
2023-12-29,McNeese St.,87,Michigan,76,11
2023-11-06,James Madison,79,Michigan St.,76,3
2023-11-09,Southern Indiana,51,Michigan St.,74,-23
2023-11-14,Duke,74,Michigan St.,65,9
2023-11-17,Butler,54,Michigan St.,74,-20
2023-11-19,Alcorn St.,49,Michigan St.,81,-32
2023-11-28,Georgia Southern,55,Michigan St.,86,-31
2023-12-05,Wisconsin,70,Michigan St.,57,13
2023-12-16,Baylor,64,Michigan St.,88,-24
2023-12-18,Oakland,62,Michigan St.,79,-17
2023-12-21,Stony Brook,55,Michigan St.,99,-44
2023-12-30,Indiana St.,75,Michigan St.,87,-12
2023-11-06,Northern Kentucky,57,Middle Tennessee,74,-17
2023-11-09,Stephen F. Austin,62,Middle Tennessee,67,-5
2023-11-13,Western Carolina,66,Middle Tennessee,64,2
2023-11-18,Milligan,62,Middle Tennessee,88,-26
2023-11-21,UAB,58,Middle Tennessee,57,1
2023-11-26,UMKC,59,Middle Tennessee,63,-4
2023-12-02,Wofford,74,Middle Tennessee,64,10
2023-12-05,Missouri St.,73,Middle Tennessee,77,-4
2023-12-09,Belmont,75,Middle Tennessee,65,10
2023-11-06,Wisconsin Stout,73,Milwaukee,91,-18
2023-11-17,Luther,56,Milwaukee,85,-29
2023-11-20,Stetson,85,Milwaukee,67,18
2023-11-21,Siena,59,Milwaukee,61,-2
2023-11-25,Southern Miss,90,Milwaukee,84,6
2023-12-13,Longwood,80,Milwaukee,67,13
2023-12-22,Chattanooga,83,Milwaukee,85,-2
2023-12-29,Robert Morris,75,Milwaukee,78,-3
2023-12-31,Wright St.,83,Milwaukee,91,-8
2023-11-06,Bethune Cookman,60,Minnesota,80,-20
2023-11-10,UTSA,76,Minnesota,102,-26
2023-11-16,Missouri,70,Minnesota,68,2
2023-11-18,USC Upstate,53,Minnesota,67,-14
2023-11-21,Arkansas Pine Bluff,67,Minnesota,86,-19
2023-11-30,New Orleans,64,Minnesota,97,-33
2023-12-06,Nebraska,65,Minnesota,76,-11
2023-12-09,Florida Gulf Coast,57,Minnesota,77,-20
2023-12-12,IUPUI,65,Minnesota,101,-36
2023-12-21,Ball St.,63,Minnesota,80,-17
2023-12-29,Maine,62,Minnesota,80,-18
2023-11-06,Alabama St.,59,Mississippi,69,-10
2023-11-10,Eastern Washington,64,Mississippi,75,-11
2023-11-14,Detroit Mercy,69,Mississippi,70,-1
2023-11-17,Sam Houston St.,67,Mississippi,70,-3
2023-11-28,N.C. State,52,Mississippi,72,-20
2023-12-02,Memphis,77,Mississippi,80,-3
2023-12-05,Mount St. Mary's,68,Mississippi,77,-9
2023-12-16,California,78,Mississippi,88,-10
2023-12-19,Troy,53,Mississippi,74,-21
2023-12-23,Southern Miss,72,Mississippi,89,-17
2023-12-31,Bryant,78,Mississippi,95,-17
2023-11-08,Arizona St.,56,Mississippi St.,71,-15
2023-11-11,Tennessee Martin,63,Mississippi St.,87,-24
2023-11-14,North Alabama,54,Mississippi St.,81,-27
2023-11-24,Nicholls St.,61,Mississippi St.,74,-13
2023-12-03,Southern,60,Mississippi St.,59,1
2023-12-09,Tulane,76,Mississippi St.,106,-30
2023-12-13,Murray St.,81,Mississippi St.,85,-4
2023-12-17,North Texas,54,Mississippi St.,72,-18
2023-12-31,Bethune Cookman,62,Mississippi St.,85,-23
2023-11-06,Arkansas Pine Bluff,79,Missouri,101,-22
2023-11-10,Memphis,70,Missouri,55,15
2023-11-13,SIU Edwardsville,50,Missouri,68,-18
2023-11-19,Jackson St.,73,Missouri,72,1
2023-11-22,South Carolina St.,59,Missouri,82,-23
2023-11-25,Loyola MD,70,Missouri,78,-8
2023-12-03,Wichita St.,72,Missouri,82,-10
2023-12-17,Seton Hall,93,Missouri,87,6
2023-12-22,Illinois,97,Missouri,73,24
2023-12-30,Central Arkansas,59,Missouri,92,-33
2023-11-13,Oral Roberts,69,Missouri St.,84,-15
2023-11-19,Kent St.,52,Missouri St.,56,-4
2023-11-20,Abilene Christian,69,Missouri St.,87,-18
2023-11-25,South Carolina St.,74,Missouri St.,92,-18
2023-11-29,Evansville,78,Missouri St.,90,-12
2023-12-09,Sam Houston St.,60,Missouri St.,69,-9
2023-12-19,Lindenwood,57,Missouri St.,79,-22
2023-11-18,Princeton,82,Monmouth,57,25
2023-11-21,Lehigh,79,Monmouth,88,-9
2023-11-25,Lafayette,53,Monmouth,63,-10
2023-12-09,Northern Illinois,71,Monmouth,74,-3
2023-12-16,Rider,71,Monmouth,77,-6
2023-12-21,Manhattan,71,Monmouth,77,-6
2023-11-07,Northwest Indian,59,Montana,107,-48
2023-11-12,UC Davis,65,Montana,78,-13
2023-11-16,North Dakota St.,78,Montana,69,9
2023-12-02,San Jose St.,58,Montana,75,-17
2023-12-05,Montana State Northern,67,Montana,91,-24
2023-12-09,Montana Tech,67,Montana,88,-21
2023-11-06,Northwest Indian,63,Montana St.,103,-40
2023-11-20,Green Bay,54,Montana St.,53,1
2023-11-22,UC Riverside,68,Montana St.,69,-1
2023-11-26,Long Beach St.,75,Montana St.,69,6
2023-11-30,Rocky Mountain,70,Montana St.,62,8
2023-12-16,American Indian,81,Montana St.,106,-25
2023-12-19,Southern Utah,88,Montana St.,89,-1
2023-11-08,Shawnee St.,40,Morehead St.,96,-56
2023-11-14,Mercer,66,Morehead St.,74,-8
2023-11-22,Midway,53,Morehead St.,94,-41
2023-12-03,Chattanooga,80,Morehead St.,87,-7
2023-12-14,Saint Mary of the Wood,33,Morehead St.,102,-69
2023-12-21,Alice Lloyd,39,Morehead St.,101,-62
2023-11-09,Cheyney,52,Morgan St.,100,-48
2023-11-12,Penn St. Wilkes Barre,60,Morgan St.,78,-18
2023-12-03,Longwood,88,Morgan St.,54,34
2023-12-06,UMBC,80,Morgan St.,92,-12
2023-12-09,Virginia Lynchburg,50,Morgan St.,120,-70
2023-12-22,James Madison,89,Morgan St.,75,14
2023-11-11,Coppin St.,60,Mount St. Mary's,74,-14
2023-11-25,Howard,87,Mount St. Mary's,83,4
2023-12-03,Siena,48,Mount St. Mary's,80,-32
2023-12-23,LIU,59,Mount St. Mary's,87,-28
2023-11-06,Midway,58,Murray St.,91,-33
2023-11-10,Tennessee Tech,72,Murray St.,78,-6
2023-11-14,Western Kentucky,86,Murray St.,81,5
2023-11-20,UNC Wilmington,83,Murray St.,81,2
2023-11-22,Appalachian St.,67,Murray St.,57,10
2023-11-29,Bradley,72,Murray St.,79,-7
2023-12-16,Southeastern Louisiana,61,Murray St.,55,6
2023-12-22,SMU,92,Murray St.,65,27
2023-12-30,Middle Tennessee,54,Murray St.,75,-21
2023-11-06,The Citadel,59,N.C. State,72,-13
2023-11-10,Abilene Christian,64,N.C. State,84,-20
2023-11-17,Charleston Southern,53,N.C. State,87,-34
2023-12-06,Maryland Eastern Shore,61,N.C. State,93,-32
2023-12-12,Tennessee Martin,67,N.C. State,81,-14
2023-12-20,Saint Louis,70,N.C. State,82,-12
2023-12-23,Detroit Mercy,66,N.C. State,83,-17
2023-11-11,Saint Peter's,75,NJIT,48,27
2023-11-20,Delaware St.,72,NJIT,81,-9
2023-12-02,Fairleigh Dickinson,71,NJIT,68,3
2023-12-22,Medgar Evers,51,NJIT,127,-76
2023-12-31,Morgan St.,53,NJIT,69,-16
2023-11-10,Temple,75,Navy,68,7
2023-11-29,VMI,47,Navy,67,-20
2023-12-03,Coppin St.,52,Navy,75,-23
2023-12-17,Washington MD,33,Navy,91,-58
2023-12-30,William & Mary,65,Navy,77,-12
2023-11-06,Lindenwood,52,Nebraska,84,-32
2023-11-09,Florida A&M,54,Nebraska,81,-27
2023-11-13,Rider,50,Nebraska,64,-14
2023-11-15,Stony Brook,63,Nebraska,84,-21
2023-11-18,Oregon St.,63,Nebraska,84,-21
2023-11-22,Duquesne,79,Nebraska,89,-10
2023-11-26,Cal St. Fullerton,72,Nebraska,85,-13
2023-12-03,Creighton,89,Nebraska,60,29
2023-12-10,Michigan St.,70,Nebraska,77,-7
2023-12-20,North Dakota,75,Nebraska,83,-8
2023-12-29,South Carolina St.,62,Nebraska,91,-29
2023-11-06,Doane,53,Nebraska Omaha,85,-32
2023-11-16,William & Mary,83,Nebraska Omaha,89,-6
2023-11-22,Mid America Christian,59,Nebraska Omaha,76,-17
2023-11-27,York NE,68,Nebraska Omaha,104,-36
2023-11-30,Bellevue,59,Nebraska Omaha,78,-19
2023-12-17,Stetson,80,Nebraska Omaha,88,-8
2023-12-29,Denver,95,Nebraska Omaha,80,15
2023-11-07,Sacramento St.,63,Nevada,77,-14
2023-11-15,Pacific,39,Nevada,88,-49
2023-11-18,Portland,83,Nevada,108,-25
2023-11-29,Montana,66,Nevada,77,-11
2023-12-02,Loyola Marymount,59,Nevada,73,-14
2023-12-06,UC Davis,68,Nevada,80,-12
2023-12-09,Drake,72,Nevada,53,19
2023-12-13,Weber St.,55,Nevada,72,-17
2023-12-21,Temple,56,Nevada,80,-24
2023-12-30,Fresno Pacific,59,Nevada,92,-33
2023-11-08,Curry,38,New Hampshire,115,-77
2023-11-14,Brown,64,New Hampshire,82,-18
2023-11-21,Marist,71,New Hampshire,74,-3
2023-12-03,Columbia,71,New Hampshire,80,-9
2023-12-11,Stonehill,62,New Hampshire,75,-13
2023-11-06,Texas Southern,55,New Mexico,92,-37
2023-11-16,UT Arlington,80,New Mexico,82,-2
2023-11-21,Toledo,84,New Mexico,92,-8
2023-11-24,Pepperdine,71,New Mexico,90,-19
2023-11-29,Louisiana Tech,65,New Mexico,74,-9
2023-12-02,New Mexico St.,62,New Mexico,106,-44
2023-12-06,UC Santa Barbara,61,New Mexico,84,-23
2023-12-09,Santa Clara,76,New Mexico,93,-17
2023-12-20,UC Irvine,65,New Mexico,78,-13
2023-12-29,Eastern New Mexico,54,New Mexico,87,-33
2023-11-08,Sul Ross St.,49,New Mexico St.,84,-35
2023-11-14,Western New Mexico,43,New Mexico St.,78,-35
2023-11-18,Northern Colorado,71,New Mexico St.,76,-5
2023-11-21,Fresno St.,81,New Mexico St.,76,5
2023-11-22,Southern Illinois,81,New Mexico St.,54,27
2023-11-28,Southwest,49,New Mexico St.,84,-35
2023-12-12,Northern New Mexico,71,New Mexico St.,76,-5
2023-12-15,New Mexico,73,New Mexico St.,72,1
2023-12-30,Cal Baptist,61,New Mexico St.,66,-5
2023-11-06,Millsaps,70,New Orleans,100,-30
2023-11-11,Southern New Orleans,69,New Orleans,106,-37
2023-12-05,Belhaven,65,New Orleans,79,-14
2023-12-14,Birmingham Southern,51,New Orleans,91,-40
2023-11-11,Bucknell,73,Niagara,64,9
2023-12-01,Saint Peter's,72,Niagara,67,5
2023-12-03,Quinnipiac,75,Niagara,68,7
2023-12-06,St. Bonaventure,94,Niagara,60,34
2023-12-10,Buffalo St.,64,Niagara,113,-49
2023-12-16,NJIT,81,Niagara,89,-8
2023-11-15,Denver,91,Nicholls St.,85,6
2023-11-17,SIU Edwardsville,60,Nicholls St.,51,9
2023-11-21,Blue Mountain,56,Nicholls St.,86,-30
2023-12-09,Elizabeth City St.,70,Nicholls St.,84,-14
2023-12-30,Mobile,65,Nicholls St.,74,-9
2023-11-06,Penn St. Wilkes Barre,55,Norfolk St.,102,-47
2023-11-09,The Apprentice School,56,Norfolk St.,90,-34
2023-11-13,Hampton,68,Norfolk St.,75,-7
2023-11-28,William & Mary,62,Norfolk St.,96,-34
2023-12-18,Southern Virginia,52,Norfolk St.,108,-56
2023-12-21,South Dakota St.,65,Norfolk St.,84,-19
2023-11-06,Blue Mountain,60,North Alabama,93,-33
2023-11-09,Alabama A&M,67,North Alabama,83,-16
2023-11-18,Jacksonville St.,59,North Alabama,61,-2
2023-11-30,Tennessee Tech,71,North Alabama,86,-15
2023-12-07,Point,65,North Alabama,109,-44
2023-12-10,Morehead St.,86,North Alabama,77,9
2023-11-06,Radford,70,North Carolina,86,-16
2023-11-12,Lehigh,68,North Carolina,90,-22
2023-11-17,UC Riverside,52,North Carolina,77,-25
2023-11-29,Tennessee,92,North Carolina,100,-8
2023-12-02,Florida St.,70,North Carolina,78,-8
2023-12-05,Connecticut,87,North Carolina,76,11
2023-12-16,Kentucky,87,North Carolina,83,4
2023-12-20,Oklahoma,69,North Carolina,81,-12
2023-12-29,Charleston Southern,60,North Carolina,105,-45
2023-11-24,Alabama St.,88,North Carolina A&T,73,15
2023-12-02,The Citadel,85,North Carolina A&T,68,17
2023-12-12,North Carolina Central,67,North Carolina A&T,62,5
2023-12-16,Texas Southern,79,North Carolina A&T,85,-6
2023-11-09,Virginia Lynchburg,54,North Carolina Central,107,-53
2023-11-14,Mid Atlantic Christian,50,North Carolina Central,113,-63
2023-12-02,USC Upstate,85,North Carolina Central,82,3
2023-12-15,St. Andrews Pres.,50,North Carolina Central,102,-52
2023-12-20,Longwood,70,North Carolina Central,79,-9
2023-11-12,Elon,68,North Dakota,85,-17
2023-11-16,Valley City St.,63,North Dakota,93,-30
2023-11-25,New Orleans,69,North Dakota,71,-2
2023-11-28,Concordia MN,56,North Dakota,87,-31
2023-12-09,Portland,83,North Dakota,72,11
2023-12-12,Waldorf,36,North Dakota,87,-51
2023-12-29,St. Thomas,70,North Dakota,45,25
2023-11-08,Mount Marty,66,North Dakota St.,93,-27
2023-11-20,Wisconsin Stout,72,North Dakota St.,101,-29
2023-12-04,San Jose St.,78,North Dakota St.,83,-5
2023-12-07,Portland,67,North Dakota St.,78,-11
2023-12-10,Oak Hill Christian,14,North Dakota St.,108,-94
2023-12-29,South Dakota,75,North Dakota St.,66,9
2023-11-06,Coastal Georgia,55,North Florida,92,-37
2023-11-16,Presbyterian,81,North Florida,69,12
2023-11-17,Northwestern St.,74,North Florida,80,-6
2023-11-18,Maine,58,North Florida,67,-9
2023-12-02,High Point,86,North Florida,79,7
2023-12-05,Edward Waters,47,North Florida,99,-52
2023-12-09,Georgia Southern,56,North Florida,64,-8
2023-12-16,Trinity Baptist,72,North Florida,113,-41
2023-11-07,Northern Iowa,77,North Texas,83,-6
2023-11-11,Nebraska Omaha,64,North Texas,75,-11
2023-11-16,St. John's,53,North Texas,52,1
2023-11-26,Angelo St.,50,North Texas,79,-29
2023-12-02,Mississippi Valley St.,48,North Texas,79,-31
2023-12-23,UT Arlington,52,North Texas,78,-26
2023-12-30,LSU Shreveport,57,North Texas,80,-23
2023-11-06,Boston University,58,Northeastern,67,-9
2023-11-20,Kennesaw St.,79,Northeastern,77,2
2023-11-21,Georgia Southern,76,Northeastern,93,-17
2023-12-02,Old Dominion,68,Northeastern,81,-13
2023-12-06,Vermont,73,Northeastern,71,2
2023-11-18,VMI,69,Northern Arizona,78,-9
2023-12-02,Pacific,58,Northern Arizona,78,-20
2023-12-16,Southern Utah,74,Northern Arizona,76,-2
2023-11-06,Colorado College,58,Northern Colorado,87,-29
2023-11-08,Northern New Mexico,60,Northern Colorado,81,-21
2023-11-14,Colorado St.,83,Northern Colorado,64,19
2023-11-21,Chicago St.,77,Northern Colorado,78,-1
2023-11-22,Radford,79,Northern Colorado,68,11
2023-12-02,Cal St. Northridge,71,Northern Colorado,75,-4
2023-12-30,Northern Arizona,77,Northern Colorado,92,-15
2023-11-11,Appalachian St.,78,Northern Illinois,91,-13
2023-11-13,Illinois Tech,55,Northern Illinois,107,-52
2023-12-05,Indiana St.,90,Northern Illinois,67,23
2023-12-18,Calumet,48,Northern Illinois,92,-44
2023-12-21,Northern Iowa,76,Northern Illinois,63,13
2023-11-14,Loras,50,Northern Iowa,90,-40
2023-11-22,North Carolina,91,Northern Iowa,69,22
2023-11-29,Belmont,90,Northern Iowa,70,20
2023-12-06,Richmond,73,Northern Iowa,78,-5
2023-12-12,Prairie View A&M,55,Northern Iowa,74,-19
2023-12-17,Alcorn St.,82,Northern Iowa,100,-18
2023-11-14,DePauw,68,Northern Kentucky,85,-17
2023-11-22,Texas A&M Corpus Chris,73,Northern Kentucky,88,-15
2023-11-25,LIU,64,Northern Kentucky,72,-8
2023-11-29,Robert Morris,59,Northern Kentucky,77,-18
2023-12-09,Akron,77,Northern Kentucky,76,1
2023-12-14,Cumberlands,59,Northern Kentucky,94,-35
2023-11-06,Binghamton,61,Northwestern,72,-11
2023-11-10,Dayton,66,Northwestern,71,-5
2023-11-14,Western Michigan,59,Northwestern,63,-4
2023-11-18,Rhode Island,61,Northwestern,72,-11
2023-11-19,Mississippi St.,66,Northwestern,57,9
2023-11-27,Northern Illinois,67,Northwestern,89,-22
2023-12-01,Purdue,88,Northwestern,92,-4
2023-12-10,Detroit Mercy,59,Northwestern,91,-32
2023-12-13,Chicago St.,75,Northwestern,73,2
2023-12-29,Jackson St.,63,Northwestern,74,-11
2023-11-06,Dallas Christian,54,Northwestern St.,101,-47
2023-11-13,Stephen F. Austin,96,Northwestern St.,70,26
2023-11-16,Maine,78,Northwestern St.,65,13
2023-12-16,Rice,76,Northwestern St.,51,25
2023-12-19,Southern New Orleans,75,Northwestern St.,99,-24
2023-11-06,Niagara,63,Notre Dame,70,-7
2023-11-11,Western Carolina,71,Notre Dame,61,10
2023-11-16,Auburn,83,Notre Dame,59,24
2023-11-17,Oklahoma St.,64,Notre Dame,66,-2
2023-11-22,Maryland Eastern Shore,55,Notre Dame,75,-20
2023-12-05,Western Michigan,65,Notre Dame,86,-21
2023-12-16,Georgetown,72,Notre Dame,68,4
2023-12-19,The Citadel,65,Notre Dame,45,20
2023-12-22,Marist,56,Notre Dame,60,-4
2023-12-30,Virginia,54,Notre Dame,76,-22
2023-11-14,Bowling Green,62,Oakland,81,-19
2023-12-02,Purdue Fort Wayne,98,Oakland,77,21
2023-12-06,Toledo,69,Oakland,68,1
2023-11-08,Troy,70,Ohio,88,-18
2023-11-18,Detroit Mercy,52,Ohio,71,-19
2023-11-25,Middle Tennessee,68,Ohio,80,-12
2023-11-26,Brown,77,Ohio,82,-5
2023-12-02,Delaware,73,Ohio,74,-1
2023-12-06,Youngstown St.,78,Ohio,72,6
2023-12-09,Marshall,74,Ohio,69,5
2023-12-18,Defiance,28,Ohio,108,-80
2023-12-30,Davidson,72,Ohio,69,3
2023-11-06,Oakland,73,Ohio St.,79,-6
2023-11-10,Texas A&M,73,Ohio St.,66,7
2023-11-15,Merrimack,52,Ohio St.,76,-24
2023-11-19,Western Michigan,56,Ohio St.,73,-17
2023-11-24,Alabama,81,Ohio St.,92,-11
2023-11-29,Central Michigan,61,Ohio St.,88,-27
2023-12-03,Minnesota,74,Ohio St.,84,-10
2023-12-06,Miami OH,64,Ohio St.,84,-20
2023-12-16,UCLA,60,Ohio St.,67,-7
2023-12-21,New Orleans,36,Ohio St.,78,-42
2023-12-30,West Virginia,75,Ohio St.,78,-3
2023-11-06,Central Michigan,59,Oklahoma,89,-30
2023-11-10,Mississippi Valley St.,43,Oklahoma,82,-39
2023-11-14,Texas St.,54,Oklahoma,93,-39
2023-11-17,UT Rio Grande Valley,66,Oklahoma,90,-24
2023-11-30,Arkansas Pine Bluff,86,Oklahoma,107,-21
2023-12-05,Providence,51,Oklahoma,72,-21
2023-12-09,Arkansas,70,Oklahoma,79,-9
2023-12-16,Green Bay,47,Oklahoma,81,-34
2023-12-28,Central Arkansas,72,Oklahoma,88,-16
2023-12-31,Monmouth,56,Oklahoma,72,-16
2023-11-06,Abilene Christian,64,Oklahoma St.,59,5
2023-11-12,Sam Houston St.,70,Oklahoma St.,85,-15
2023-11-16,St. Bonaventure,66,Oklahoma St.,64,2
2023-11-20,New Orleans,68,Oklahoma St.,96,-28
2023-11-24,Houston Christian,65,Oklahoma St.,92,-27
2023-11-30,Creighton,79,Oklahoma St.,65,14
2023-12-10,Tulsa,57,Oklahoma St.,72,-15
2023-12-17,Oral Roberts,60,Oklahoma St.,81,-21
2023-12-20,Wofford,70,Oklahoma St.,76,-6
2023-12-31,South Carolina St.,70,Oklahoma St.,86,-16
2023-11-06,Virginia Wesleyan,57,Old Dominion,71,-14
2023-11-22,Princeton,76,Old Dominion,56,20
2023-11-26,Drexel,61,Old Dominion,68,-7
2023-11-29,Radford,68,Old Dominion,69,-1
2023-12-09,James Madison,84,Old Dominion,69,15
2023-12-21,TCU,111,Old Dominion,87,24
2023-12-22,Temple,63,Old Dominion,78,-15
2023-12-30,South Alabama,61,Old Dominion,59,2
2023-11-10,Mid America Christian,69,Oral Roberts,74,-5
2023-11-21,Texas Southern,63,Oral Roberts,65,-2
2023-12-02,Tulsa,70,Oral Roberts,79,-9
2023-12-09,Ozark Christian,51,Oral Roberts,110,-59
2023-12-19,John Brown,59,Oral Roberts,71,-12
2023-11-06,Georgia,71,Oregon,82,-11
2023-11-10,Montana,61,Oregon,75,-14
2023-11-17,Tennessee St.,67,Oregon,92,-25
2023-11-25,Alabama,99,Oregon,91,8
2023-12-02,Michigan,83,Oregon,86,-3
2023-12-09,UTEP,49,Oregon,71,-22
2023-12-12,Cal Baptist,55,Oregon,76,-21
2023-12-17,Syracuse,83,Oregon,63,20
2023-12-21,Kent St.,70,Oregon,84,-14
2023-12-28,USC,74,Oregon,82,-8
2023-12-30,UCLA,59,Oregon,64,-5
2023-11-06,Linfield,46,Oregon St.,82,-36
2023-11-10,Troy,80,Oregon St.,81,-1
2023-11-14,Appalachian St.,71,Oregon St.,81,-10
2023-11-22,Baylor,88,Oregon St.,72,16
2023-11-30,UC Davis,59,Oregon St.,71,-12
2023-12-04,Cal Poly,63,Oregon St.,70,-7
2023-12-09,Utah Valley,71,Oregon St.,74,-3
2023-12-17,UTSA,65,Oregon St.,66,-1
2023-12-21,Idaho St.,57,Oregon St.,76,-19
2023-12-28,UCLA,69,Oregon St.,62,7
2023-12-30,USC,70,Oregon St.,86,-16
2023-11-06,Sam Houston St.,64,Pacific,57,7
2023-11-18,Lamar,76,Pacific,77,-1
2023-11-20,North Dakota,73,Pacific,71,2
2023-11-24,Le Moyne,71,Pacific,73,-2
2023-11-26,Mississippi Valley St.,65,Pacific,68,-3
2023-11-29,Cal St. Northridge,80,Pacific,69,11
2023-12-16,UC Davis,82,Pacific,61,21
2023-12-18,Cal St.Stanislaus,46,Pacific,68,-22
2023-12-30,California Maritime,66,Pacific,80,-14
2023-11-06,John Jay,57,Penn,102,-45
2023-11-08,Bucknell,61,Penn,80,-19
2023-11-13,Villanova,72,Penn,76,-4
2023-11-24,Lafayette,72,Penn,74,-2
2023-11-25,Belmont,84,Penn,79,5
2023-11-26,Monmouth,61,Penn,76,-15
2023-12-02,La Salle,93,Penn,92,1
2023-12-06,FDU Florham,57,Penn,111,-54
2023-12-09,Kentucky,81,Penn,66,15
2023-12-11,Howard,68,Penn,78,-10
2023-11-06,Delaware St.,45,Penn St.,79,-34
2023-11-10,Lehigh,65,Penn St.,74,-9
2023-11-14,Saint Francis,53,Penn St.,83,-30
2023-11-17,Morehead St.,51,Penn St.,74,-23
2023-12-02,Bucknell,76,Penn St.,67,9
2023-12-09,Ohio St.,80,Penn St.,83,-3
2023-12-16,Georgia Tech,82,Penn St.,81,1
2023-12-21,Le Moyne,55,Penn St.,72,-17
2023-12-29,Rider,63,Penn St.,90,-27
2023-11-06,Concordia CA,64,Pepperdine,76,-12
2023-11-12,Lafayette,53,Pepperdine,76,-23
2023-11-13,LIU,53,Pepperdine,88,-35
2023-11-17,UNLV,82,Pepperdine,68,14
2023-11-22,Indiana St.,90,Pepperdine,82,8
2023-11-28,Idaho St.,62,Pepperdine,77,-15
2023-12-06,Cal St. Fullerton,60,Pepperdine,55,5
2023-12-09,UC San Diego,62,Pepperdine,68,-6
2023-12-21,William & Mary,59,Pepperdine,71,-12
2023-12-29,Westcliff,47,Pepperdine,83,-36
2023-11-06,North Carolina A&T,52,Pittsburgh,100,-48
2023-11-10,Binghamton,60,Pittsburgh,89,-29
2023-11-13,Florida Gulf Coast,74,Pittsburgh,86,-12
2023-11-17,Jacksonville,56,Pittsburgh,107,-51
2023-11-22,Florida,86,Pittsburgh,71,15
2023-11-24,Oregon St.,51,Pittsburgh,76,-25
2023-11-28,Missouri,71,Pittsburgh,64,7
2023-12-03,Clemson,79,Pittsburgh,70,9
2023-12-09,Canisius,71,Pittsburgh,82,-11
2023-12-16,South Carolina St.,50,Pittsburgh,86,-36
2023-12-20,Purdue Fort Wayne,48,Pittsburgh,62,-14
2023-11-06,Long Beach St.,73,Portland,78,-5
2023-11-08,Lewis & Clark,72,Portland,89,-17
2023-11-12,UC Riverside,65,Portland,76,-11
2023-11-15,Tennessee St.,75,Portland,65,10
2023-11-25,Willamette,84,Portland,107,-23
2023-12-01,Wyoming,70,Portland,81,-11
2023-12-03,Air Force,80,Portland,58,22
2023-12-22,Massachusetts,100,Portland,78,22
2023-12-24,Temple,55,Portland,54,1
2023-11-12,Linfield,53,Portland St.,70,-17
2023-11-19,St. Thomas,76,Portland St.,70,6
2023-11-28,Portland,74,Portland St.,75,-1
2023-12-06,Lewis & Clark,60,Portland St.,104,-44
2023-12-09,George Fox,77,Portland St.,83,-6
2023-11-06,Kansas Christian,66,Prairie View A&M,89,-23
2023-12-18,North American,61,Prairie View A&M,92,-31
2023-11-09,Columbia International,58,Presbyterian,100,-42
2023-11-13,The Citadel,64,Presbyterian,71,-7
2023-11-18,Northwestern St.,75,Presbyterian,78,-3
2023-11-22,Tennessee Tech,79,Presbyterian,75,4
2023-12-06,Florida A&M,65,Presbyterian,60,5
2023-12-13,Mid Atlantic Christian,51,Presbyterian,118,-67
2023-12-16,Kennesaw St.,94,Presbyterian,84,10
2023-12-30,Johnson & Wales NC,67,Presbyterian,91,-24
2023-11-25,Northeastern,66,Princeton,80,-14
2023-12-02,Furman,69,Princeton,70,-1
2023-12-05,Drexel,70,Princeton,81,-11
2023-12-13,Bryn Athyn,40,Princeton,92,-52
2023-12-22,Delaware Valley,53,Princeton,84,-31
2023-11-06,Columbia,59,Providence,78,-19
2023-11-11,Milwaukee,69,Providence,79,-10
2023-11-14,Wisconsin,59,Providence,72,-13
2023-11-17,Kansas St.,73,Providence,70,3
2023-11-19,Georgia,64,Providence,71,-7
2023-11-24,Lehigh,64,Providence,78,-14
2023-11-28,Wagner,52,Providence,86,-34
2023-12-02,Rhode Island,69,Providence,84,-15
2023-12-10,Brown,54,Providence,74,-20
2023-12-16,Sacred Heart,64,Providence,78,-14
2023-12-19,Marquette,57,Providence,72,-15
2023-12-23,Butler,75,Providence,85,-10
2023-11-06,Samford,45,Purdue,98,-53
2023-11-10,Morehead St.,57,Purdue,87,-30
2023-11-13,Xavier,71,Purdue,83,-12
2023-11-21,Tennessee,67,Purdue,71,-4
2023-11-28,Texas Southern,67,Purdue,99,-32
2023-12-04,Iowa,68,Purdue,87,-19
2023-12-16,Arizona,84,Purdue,92,-8
2023-12-21,Jacksonville,57,Purdue,100,-43
2023-12-29,Eastern Kentucky,53,Purdue,80,-27
2023-11-09,Andrews,34,Purdue Fort Wayne,130,-96
2023-11-12,Texas A&M Commerce,64,Purdue Fort Wayne,86,-22
2023-11-17,Northern Arizona,67,Purdue Fort Wayne,77,-10
2023-11-18,South Dakota,81,Purdue Fort Wayne,93,-12
2023-11-25,Wittenberg,64,Purdue Fort Wayne,95,-31
2023-11-29,Green Bay,71,Purdue Fort Wayne,75,-4
2023-12-09,Southeast Missouri St.,80,Purdue Fort Wayne,89,-9
2023-12-16,Bethune Cookman,63,Purdue Fort Wayne,86,-23
2023-12-29,Northern Kentucky,60,Purdue Fort Wayne,73,-13
2023-12-31,Detroit Mercy,56,Purdue Fort Wayne,91,-35
2023-11-14,High Point,72,Queens,74,-2
2023-11-22,Fairleigh Dickinson,84,Queens,97,-13
2023-11-29,Gardner Webb,80,Queens,83,-3
2023-12-01,Carolina Christian,69,Queens,134,-65
2023-12-09,Carolina,64,Queens,112,-48
2023-12-13,Appalachian St.,93,Queens,81,12
2023-11-06,Coast Guard,48,Quinnipiac,116,-68
2023-11-10,Central Connecticut,70,Quinnipiac,74,-4
2023-11-19,Albany,82,Quinnipiac,85,-3
2023-11-26,Stonehill,69,Quinnipiac,80,-11
2023-12-08,Navy,68,Quinnipiac,71,-3
2023-12-11,Yale,73,Quinnipiac,66,7
2023-11-12,Eastern Mennonite,47,Radford,84,-37
2023-11-21,Morgan St.,72,Radford,82,-10
2023-11-26,Notre Dame MD,53,Radford,100,-47
2023-12-03,Elon,72,Radford,82,-10
2023-12-09,North Carolina Central,74,Radford,82,-8
2023-12-12,VMI,56,Radford,73,-17
2023-11-06,Central Connecticut,70,Rhode Island,81,-11
2023-11-09,Fairfield,80,Rhode Island,93,-13
2023-11-14,Wagner,53,Rhode Island,69,-16
2023-11-19,Washington St.,78,Rhode Island,57,21
2023-11-22,Johnson & Wales RI,59,Rhode Island,97,-38
2023-11-26,Yale,72,Rhode Island,76,-4
2023-12-06,Brown,67,Rhode Island,64,3
2023-12-16,Delaware,67,Rhode Island,56,11
2023-12-21,New Hampshire,81,Rhode Island,71,10
2023-12-30,Northeastern,71,Rhode Island,82,-11
2023-11-07,St. Thomas TX,57,Rice,101,-44
2023-11-10,Harvard,89,Rice,76,13
2023-11-22,New Mexico,90,Rice,56,34
2023-11-30,Tennessee Martin,78,Rice,98,-20
2023-12-02,Houston Christian,56,Rice,65,-9
2023-12-13,Incarnate Word,57,Rice,80,-23
2023-12-20,Prairie View A&M,56,Rice,82,-26
2023-12-22,Louisiana,84,Rice,67,17
2023-11-06,VMI,75,Richmond,93,-18
2023-11-11,Siena,48,Richmond,90,-42
2023-11-20,Colorado,64,Richmond,59,5
2023-11-21,UNLV,65,Richmond,82,-17
2023-11-25,Queens,61,Richmond,90,-29
2023-12-02,William & Mary,69,Richmond,88,-19
2023-12-16,Charlotte,56,Richmond,64,-8
2023-12-21,Buffalo,66,Richmond,72,-6
2023-12-30,Lafayette,38,Richmond,59,-21
2023-11-06,Immaculata,67,Rider,113,-46
2023-12-03,Fairfield,88,Rider,81,7
2023-12-08,Stonehill,56,Rider,73,-17
2023-12-23,Penn,77,Rider,73,4
2023-11-09,Point Park,56,Robert Morris,66,-10
2023-11-24,Jacksonville,74,Robert Morris,65,9
2023-11-26,Fairleigh Dickinson,86,Robert Morris,97,-11
2023-12-02,Youngstown St.,71,Robert Morris,57,14
2023-12-11,Delaware,73,Robert Morris,69,4
2023-12-17,St. Vincent,46,Robert Morris,95,-49
2023-12-22,Cornell,90,Robert Morris,85,5
2023-11-06,Princeton,68,Rutgers,61,7
2023-11-10,Boston University,45,Rutgers,69,-24
2023-11-12,Bryant,57,Rutgers,66,-9
2023-11-15,Georgetown,60,Rutgers,71,-11
2023-11-18,Howard,63,Rutgers,85,-22
2023-11-27,Saint Peter's,40,Rutgers,71,-31
2023-12-02,Illinois,76,Rutgers,58,18
2023-12-16,LIU,61,Rutgers,83,-22
2023-12-23,Mississippi St.,70,Rutgers,60,10
2023-12-30,Stonehill,58,Rutgers,59,-1
2023-11-09,North Park,67,SIU Edwardsville,92,-25
2023-11-16,Denver,74,SIU Edwardsville,77,-3
2023-11-25,Detroit Mercy,67,SIU Edwardsville,81,-14
2023-11-28,Missouri Baptist,62,SIU Edwardsville,86,-24
2023-12-06,Green Bay,69,SIU Edwardsville,78,-9
2023-12-18,Central Christian MO,56,SIU Edwardsville,99,-43
2023-12-29,Eastern Illinois,58,SIU Edwardsville,67,-9
2023-12-31,Western Illinois,78,SIU Edwardsville,70,8
2023-11-06,SW Assemblies of God,63,SMU,82,-19
2023-11-08,Western Illinois,53,SMU,90,-37
2023-11-09,Lamar,67,SMU,78,-11
2023-11-14,Texas A&M,79,SMU,66,13
2023-11-20,West Virginia,58,SMU,70,-12
2023-11-22,Wisconsin,69,SMU,61,8
2023-11-26,Louisiana Monroe,57,SMU,70,-13
2023-11-29,Dayton,65,SMU,63,2
2023-12-03,Texas A&M Commerce,47,SMU,90,-43
2023-12-19,Houston Christian,53,SMU,89,-36
2023-11-14,Pacific Union,66,Sacramento St.,128,-62
2023-11-20,Cal St. Bakersfield,75,Sacramento St.,71,4
2023-12-09,Cal St. Fullerton,62,Sacramento St.,60,2
2023-12-18,UC San Diego,83,Sacramento St.,52,31
2023-12-21,Bethesda,45,Sacramento St.,100,-55
2023-11-06,Sarah Lawrence,51,Sacred Heart,95,-44
2023-11-21,Binghamton,75,Sacred Heart,89,-14
2023-11-30,New Hampshire,90,Sacred Heart,84,6
2023-12-02,Boston University,70,Sacred Heart,49,21
2023-12-09,Fairfield,67,Sacred Heart,57,10
2023-12-21,Dartmouth,57,Sacred Heart,67,-10
2023-12-30,Mercy,63,Sacred Heart,92,-29
2023-11-20,Pittsburgh Greensburg,63,Saint Francis,77,-14
2023-11-22,Franciscan,54,Saint Francis,107,-53
2023-11-25,Niagara,69,Saint Francis,61,8
2023-12-15,Mount St. Mary's,72,Saint Francis,65,7
2023-12-20,Robert Morris,75,Saint Francis,73,2
2023-12-30,Campbell,76,Saint Francis,78,-2
2023-11-06,Lafayette,60,Saint Joseph's,81,-21
2023-11-10,Penn,61,Saint Joseph's,69,-8
2023-11-14,Stonehill,56,Saint Joseph's,100,-44
2023-11-17,Texas A&M Commerce,57,Saint Joseph's,54,3
2023-11-26,Sacred Heart,55,Saint Joseph's,64,-9
2023-12-02,Temple,65,Saint Joseph's,74,-9
2023-12-06,American,53,Saint Joseph's,69,-16
2023-12-10,Princeton,70,Saint Joseph's,74,-4
2023-12-16,Iona,58,Saint Joseph's,83,-25
2023-12-29,Loyola MD,56,Saint Joseph's,97,-41
2023-11-06,Southern Indiana,63,Saint Louis,75,-12
2023-11-08,Lincoln MO,66,Saint Louis,102,-36
2023-11-11,Illinois St.,71,Saint Louis,80,-9
2023-11-17,Vermont,78,Saint Louis,68,10
2023-11-25,Dartmouth,65,Saint Louis,66,-1
2023-11-28,Utah St.,81,Saint Louis,76,5
2023-12-09,Hofstra,68,Saint Louis,71,-3
2023-12-16,Louisiana Tech,74,Saint Louis,75,-1
2023-11-06,Cal St.Stanislaus,28,Saint Mary's,107,-79
2023-11-09,New Mexico,58,Saint Mary's,72,-14
2023-11-12,Weber St.,61,Saint Mary's,57,4
2023-11-17,San Diego St.,79,Saint Mary's,54,25
2023-11-24,Davidson,55,Saint Mary's,89,-34
2023-11-27,Utah,78,Saint Mary's,71,7
2023-12-05,Cleveland St.,57,Saint Mary's,70,-13
2023-12-16,UNLV,67,Saint Mary's,69,-2
2023-12-19,Middle Tennessee,34,Saint Mary's,71,-37
2023-12-21,Northern Kentucky,56,Saint Mary's,92,-36
2023-12-23,Missouri St.,69,Saint Mary's,64,5
2023-12-29,Kent St.,46,Saint Mary's,66,-20
2023-11-20,UMass Lowell,69,Saint Peter's,61,8
2023-12-12,UMBC,60,Saint Peter's,66,-6
2023-12-22,Kean,70,Saint Peter's,73,-3
2023-11-09,Utah Valley,79,Sam Houston St.,73,6
2023-11-22,Grambling St.,68,Sam Houston St.,86,-18
2023-11-25,Paul Quinn,61,Sam Houston St.,78,-17
2023-12-03,Lamar,70,Sam Houston St.,90,-20
2023-12-12,Louisiana Monroe,62,Sam Houston St.,63,-1
2023-12-15,Texas St.,73,Sam Houston St.,60,13
2023-11-14,Mississippi College,52,Samford,96,-44
2023-11-17,South Carolina St.,72,Samford,89,-17
2023-11-22,Alabama St.,67,Samford,99,-32
2023-11-24,Merrimack,71,Samford,79,-8
2023-11-25,North Carolina A&T,83,Samford,101,-18
2023-11-30,Louisiana,65,Samford,88,-23
2023-12-03,LaGrange,82,Samford,128,-46
2023-12-11,Alabama A&M,91,Samford,118,-27
2023-12-16,Belmont,93,Samford,99,-6
2023-11-06,Sonoma St.,64,San Diego,68,-4
2023-11-08,Jackson St.,61,San Diego,87,-26
2023-11-17,Le Moyne,71,San Diego,80,-9
2023-11-20,Navy,59,San Diego,67,-8
2023-11-24,Arkansas St.,57,San Diego,71,-14
2023-11-25,Hawaii,77,San Diego,66,11
2023-11-29,Northern Colorado,72,San Diego,74,-2
2023-12-09,Arizona St.,84,San Diego,89,-5
2023-12-15,Portland St.,65,San Diego,69,-4
2023-12-21,South Dakota,66,San Diego,69,-3
2023-12-29,Fresno St.,71,San Diego,67,4
2023-12-31,Westcliff,65,San Diego,78,-13
2023-11-06,Cal St. Fullerton,57,San Diego St.,83,-26
2023-11-14,Long Beach St.,76,San Diego St.,88,-12
2023-11-25,California,67,San Diego St.,76,-9
2023-11-27,Point Loma Nazarene,51,San Diego St.,71,-20
2023-12-09,UC Irvine,62,San Diego St.,63,-1
2023-12-19,Saint Katherine,57,San Diego St.,91,-34
2023-12-21,Stanford,60,San Diego St.,74,-14
2023-11-06,Bethesda,59,San Francisco,128,-69
2023-11-09,Saint Francis,52,San Francisco,84,-32
2023-11-22,Purdue Fort Wayne,60,San Francisco,76,-16
2023-11-26,Minnesota,58,San Francisco,76,-18
2023-12-11,New Orleans,72,San Francisco,85,-13
2023-12-13,Seattle,59,San Francisco,62,-3
2023-12-20,Northern Arizona,51,San Francisco,91,-40
2023-12-22,Fresno St.,57,San Francisco,77,-20
2023-12-30,Mississippi Valley St.,42,San Francisco,92,-50
2023-11-07,UC Irvine,64,San Jose St.,72,-8
2023-11-09,Bethesda,72,San Jose St.,117,-45
2023-11-17,Abilene Christian,77,San Jose St.,71,6
2023-11-18,Norfolk St.,53,San Jose St.,77,-24
2023-11-27,North Dakota St.,65,San Jose St.,78,-13
2023-12-09,New Orleans,82,San Jose St.,87,-5
2023-12-17,Montana,86,San Jose St.,75,11
2023-12-20,Santa Clara,78,San Jose St.,81,-3
2023-11-08,Utah Tech,69,Santa Clara,77,-8
2023-11-11,Saint Francis,59,Santa Clara,82,-23
2023-11-18,Southeastern Louisiana,63,Santa Clara,65,-2
2023-11-20,Mississippi Valley St.,39,Santa Clara,81,-42
2023-11-24,Oregon,82,Santa Clara,88,-6
2023-11-25,Ohio St.,86,Santa Clara,56,30
2023-11-29,Menlo,69,Santa Clara,106,-37
2023-12-13,Utah St.,84,Santa Clara,82,2
2023-12-23,Duquesne,73,Santa Clara,81,-8
2023-12-30,Yale,66,Santa Clara,58,8
2023-11-08,Prairie View A&M,60,Seattle,71,-11
2023-11-11,Montana St.,68,Seattle,71,-3
2023-11-15,Northern Arizona,62,Seattle,60,2
2023-11-22,Idaho,55,Seattle,92,-37
2023-11-26,UC San Diego,67,Seattle,79,-12
2023-12-02,Southern Utah,63,Seattle,73,-10
2023-12-09,Northwest,46,Seattle,101,-55
2023-12-17,Washington,100,Seattle,99,1
2023-12-20,Louisiana Tech,73,Seattle,79,-6
2023-11-06,Saint Peter's,59,Seton Hall,70,-11
2023-11-11,Fairleigh Dickinson,55,Seton Hall,85,-30
2023-11-15,Albany,71,Seton Hall,96,-25
2023-11-18,Wagner,51,Seton Hall,72,-21
2023-11-24,Iowa,85,Seton Hall,72,13
2023-11-29,Northeastern,75,Seton Hall,88,-13
2023-12-09,Rutgers,70,Seton Hall,63,7
2023-12-12,Monmouth,61,Seton Hall,70,-9
2023-12-20,Connecticut,60,Seton Hall,75,-15
2023-11-06,Holy Cross,71,Siena,73,-2
2023-11-26,Albany,86,Siena,51,35
2023-12-01,Rider,65,Siena,67,-2
2023-12-06,Bryant,67,Siena,51,16
2023-12-19,Cornell,95,Siena,74,21
2023-11-06,Mobile,83,South Alabama,74,9
2023-11-16,Nicholls St.,102,South Alabama,97,5
2023-11-17,Denver,75,South Alabama,82,-7
2023-11-19,SIU Edwardsville,74,South Alabama,86,-12
2023-11-21,Lynn,62,South Alabama,74,-12
2023-12-09,Spring Hill,74,South Alabama,91,-17
2023-12-21,Alabama A&M,67,South Alabama,83,-16
2023-11-06,USC Upstate,53,South Carolina,82,-29
2023-11-10,Virginia Tech,77,South Carolina,79,-2
2023-11-13,VMI,64,South Carolina,74,-10
2023-11-17,DePaul,68,South Carolina,73,-5
2023-11-28,Notre Dame,53,South Carolina,65,-12
2023-12-01,George Washington,67,South Carolina,89,-22
2023-12-16,Charleston Southern,69,South Carolina,73,-4
2023-12-19,Winthrop,62,South Carolina,72,-10
2023-12-22,Elon,43,South Carolina,70,-27
2023-12-30,Florida A&M,62,South Carolina,94,-32
2023-11-06,Voorhees,57,South Carolina St.,65,-8
2023-11-13,North Florida,77,South Carolina St.,87,-10
2023-12-09,Bethune Cookman,80,South Carolina St.,71,9
2023-12-11,Jacksonville,85,South Carolina St.,86,-1
2023-12-22,Brewton Parker,84,South Carolina St.,101,-17
2023-11-06,Mount Marty,53,South Dakota,85,-32
2023-11-10,UT Rio Grande Valley,79,South Dakota,100,-21
2023-11-22,Northland,48,South Dakota,100,-52
2023-11-26,Air Force,58,South Dakota,57,1
2023-11-28,Waldorf,71,South Dakota,93,-22
2023-12-09,Cal St. Bakersfield,73,South Dakota,78,-5
2023-12-31,Nebraska Omaha,67,South Dakota,51,16
2023-11-06,Akron,81,South Dakota St.,75,6
2023-11-08,Dakota Wesleyan,55,South Dakota St.,83,-28
2023-11-20,George Mason,73,South Dakota St.,71,2
2023-11-27,Mount Marty,70,South Dakota St.,92,-22
2023-12-01,Towson,48,South Dakota St.,61,-13
2023-12-05,Kent St.,82,South Dakota St.,73,9
2023-12-14,Mayville St.,62,South Dakota St.,94,-32
2023-12-31,North Dakota,61,South Dakota St.,80,-19
2023-11-09,South Carolina St.,52,South Florida,96,-44
2023-11-15,Central Michigan,68,South Florida,63,5
2023-11-19,Northern Iowa,65,South Florida,74,-9
2023-11-22,Maine,70,South Florida,59,11
2023-12-09,Florida St.,72,South Florida,88,-16
2023-12-12,Arkansas Pine Bluff,86,South Florida,104,-18
2023-12-16,Loyola Chicago,64,South Florida,77,-13
2023-12-22,Albany,73,South Florida,89,-16
2023-12-29,Alabama St.,70,South Florida,73,-3
2023-11-15,Evansville,76,Southeast Missouri St.,57,19
2023-11-20,Central Arkansas,68,Southeast Missouri St.,70,-2
2023-11-25,Evansville,93,Southeast Missouri St.,74,19
2023-12-03,Missouri Baptist,56,Southeast Missouri St.,84,-28
2023-12-06,Harris Stowe,45,Southeast Missouri St.,95,-50
2023-12-17,Lindsey Wilson,59,Southeast Missouri St.,87,-28
2023-12-29,Southern Indiana,91,Southeast Missouri St.,93,-2
2023-12-31,Morehead St.,83,Southeast Missouri St.,64,19
2023-11-06,Delta St.,71,Southeastern Louisiana,90,-19
2023-11-25,Tennessee St.,91,Southeastern Louisiana,77,14
2023-11-28,Southern New Orleans,55,Southeastern Louisiana,101,-46
2023-12-20,Grambling St.,47,Southeastern Louisiana,48,-1
2023-12-30,Loyola LA,64,Southeastern Louisiana,87,-23
2023-12-09,Southeastern Louisiana,44,Southern,69,-25
2023-12-12,Champion Christian,61,Southern,109,-48
2023-12-19,Wiley,49,Southern,82,-33
2023-12-31,Ecclesia,42,Southern,115,-73
2023-11-06,Kentucky St.,57,Southern Illinois,88,-31
2023-11-10,Queens,68,Southern Illinois,91,-23
2023-11-16,Chicago St.,55,Southern Illinois,71,-16
2023-11-21,James Madison,82,Southern Illinois,76,6
2023-12-02,Saint Louis,62,Southern Illinois,101,-39
2023-12-05,Oklahoma St.,68,Southern Illinois,70,-2
2023-12-12,Austin Peay,70,Southern Illinois,68,2
2023-12-19,North Dakota St.,63,Southern Illinois,76,-13
2023-12-22,Southern Indiana,50,Southern Illinois,81,-31
2023-12-30,Illinois Chicago,50,Southern Illinois,62,-12
2023-11-12,Chicago St.,78,Southern Indiana,67,11
2023-11-14,Tiffin,65,Southern Indiana,68,-3
2023-11-28,East West,49,Southern Indiana,107,-58
2023-12-02,Bowling Green,54,Southern Indiana,52,2
2023-12-06,Purdue Fort Wayne,70,Southern Indiana,57,13
2023-12-19,St. Francis IL,47,Southern Indiana,79,-32
2023-11-06,William Carey,42,Southern Miss,64,-22
2023-11-15,Xavier LA,45,Southern Miss,76,-31
2023-11-19,Utah Valley,67,Southern Miss,65,2
2023-11-22,South Dakota St.,65,Southern Miss,54,11
2023-12-09,Northwestern St.,74,Southern Miss,83,-9
2023-11-09,Life Pacific,73,Southern Utah,108,-35
2023-11-29,Cal Baptist,91,Southern Utah,66,25
2023-12-09,Idaho St.,74,Southern Utah,82,-8
2023-12-22,Middle Tennessee,63,Southern Utah,69,-6
2023-12-30,Antelope Valley,78,Southern Utah,95,-17
2023-11-06,Longwood,69,St. Bonaventure,73,-4
2023-11-11,Canisius,70,St. Bonaventure,67,3
2023-11-22,Bucknell,61,St. Bonaventure,67,-6
2023-11-25,Miami OH,60,St. Bonaventure,90,-30
2023-12-09,Siena,56,St. Bonaventure,89,-33
2023-12-16,Florida Atlantic,64,St. Bonaventure,54,10
2023-12-22,Binghamton,64,St. Bonaventure,90,-26
2023-11-07,Stony Brook,74,St. John's,90,-16
2023-11-13,Michigan,89,St. John's,73,16
2023-11-25,Holy Cross,45,St. John's,91,-46
2023-12-06,Sacred Heart,50,St. John's,85,-35
2023-12-10,Boston College,86,St. John's,80,6
2023-12-16,Fordham,55,St. John's,77,-22
2023-12-20,Xavier,66,St. John's,81,-15
2023-12-30,Hofstra,79,St. John's,84,-5
2023-11-10,Idaho St.,53,St. Thomas,54,-1
2023-11-12,North Central MN,54,St. Thomas,100,-46
2023-12-06,Milwaukee,71,St. Thomas,75,-4
2023-12-17,Crown,66,St. Thomas,85,-19
2023-12-21,Wisconsin River Falls,51,St. Thomas,104,-53
2023-12-31,UMKC,56,St. Thomas,77,-21
2023-11-06,Cal St. Northridge,79,Stanford,88,-9
2023-11-10,Sacramento St.,73,Stanford,91,-18
2023-11-14,Santa Clara,89,Stanford,77,12
2023-11-17,Eastern Washington,70,Stanford,95,-25
2023-11-22,Arkansas,77,Stanford,74,3
2023-11-23,Michigan,83,Stanford,78,5
2023-11-24,Northern Iowa,73,Stanford,51,22
2023-12-03,San Diego,64,Stanford,88,-24
2023-12-17,Idaho,64,Stanford,82,-18
2023-12-29,Arizona St.,76,Stanford,73,3
2023-12-31,Arizona,82,Stanford,100,-18
2023-11-06,North American,68,Stephen F. Austin,96,-28
2023-11-20,Drake,68,Stephen F. Austin,92,-24
2023-11-29,Tarleton St.,68,Stephen F. Austin,66,2
2023-12-05,Louisiana Tech,56,Stephen F. Austin,49,7
2023-12-19,New Mexico St.,72,Stephen F. Austin,75,-3
2023-12-22,Paul Quinn,58,Stephen F. Austin,115,-57
2023-12-29,New Orleans,51,Stephen F. Austin,80,-29
2023-11-06,Trinity Baptist,54,Stetson,109,-55
2023-11-21,Central Michigan,61,Stetson,71,-10
2023-11-29,Coastal Georgia,49,Stetson,94,-45
2023-12-10,Johnson FL,43,Stetson,123,-80
2023-12-29,Charlotte,75,Stetson,79,-4
2023-11-09,Army,44,Stonehill,57,-13
2023-11-29,UMass Lowell,80,Stonehill,74,6
2023-12-02,Binghamton,79,Stonehill,64,15
2023-12-17,Hartford,44,Stonehill,71,-27
2023-11-10,St. Joseph's NY,50,Stony Brook,91,-41
2023-11-20,Rider,48,Stony Brook,55,-7
2023-12-02,Wagner,60,Stony Brook,59,1
2023-12-06,Stonehill,63,Stony Brook,81,-18
2023-12-09,Bryant,75,Stony Brook,86,-11
2023-12-13,Norfolk St.,78,Stony Brook,84,-6
2023-12-29,Brown,65,Stony Brook,69,-4
2023-11-06,New Hampshire,72,Syracuse,83,-11
2023-11-08,Canisius,77,Syracuse,89,-12
2023-11-14,Colgate,75,Syracuse,79,-4
2023-11-20,Tennessee,73,Syracuse,56,17
2023-11-28,LSU,57,Syracuse,80,-23
2023-12-05,Cornell,70,Syracuse,81,-11
2023-12-21,Niagara,71,Syracuse,83,-12
2023-12-30,Pittsburgh,73,Syracuse,81,-8
2023-11-06,Southern,75,TCU,108,-33
2023-11-09,Nebraska Omaha,60,TCU,82,-22
2023-11-14,UT Rio Grande Valley,55,TCU,88,-33
2023-11-17,Mississippi Valley St.,52,TCU,86,-34
2023-11-21,Alcorn St.,74,TCU,93,-19
2023-11-27,Houston Christian,64,TCU,101,-37
2023-12-16,Arizona St.,59,TCU,79,-20
2023-12-22,Nevada,88,TCU,75,13
2023-11-11,UNT Dallas,52,Tarleton St.,93,-41
2023-11-22,Cal St. Bakersfield,40,Tarleton St.,59,-19
2023-12-02,UT Rio Grande Valley,75,Tarleton St.,77,-2
2023-12-05,Hardin Simmons,56,Tarleton St.,92,-36
2023-12-12,Sterling KS,47,Tarleton St.,85,-38
2023-12-18,Jacksonville St.,65,Tarleton St.,62,3
2023-11-06,Maryland Eastern Shore,65,Temple,85,-20
2023-11-18,Columbia,78,Temple,73,5
2023-11-22,Mississippi,77,Temple,76,1
2023-11-29,La Salle,99,Temple,106,-7
2023-12-06,Bloomsburg,55,Temple,85,-30
2023-12-10,Albany,73,Temple,78,-5
2023-11-06,Tennessee Tech,42,Tennessee,80,-38
2023-11-14,Wofford,61,Tennessee,82,-21
2023-12-05,George Mason,66,Tennessee,87,-21
2023-12-09,Illinois,79,Tennessee,86,-7
2023-12-12,Georgia Southern,56,Tennessee,74,-18
2023-12-16,N.C. State,70,Tennessee,79,-9
2023-12-21,Tarleton St.,46,Tennessee,65,-19
2023-11-06,Champion Christian,76,Tennessee Martin,104,-28
2023-11-13,Brescia,72,Tennessee Martin,90,-18
2023-11-19,Prairie View A&M,78,Tennessee Martin,66,12
2023-11-22,North Alabama,103,Tennessee Martin,105,-2
2023-12-10,Ecclesia,52,Tennessee Martin,110,-58
2023-12-20,William Woods,75,Tennessee Martin,78,-3
2023-11-06,Fisk,61,Tennessee St.,76,-15
2023-11-09,Kentucky St.,58,Tennessee St.,83,-25
2023-11-20,Midway,70,Tennessee St.,87,-17
2023-11-24,Mercer,60,Tennessee St.,59,1
2023-12-02,Austin Peay,65,Tennessee St.,69,-4
2023-12-16,Boyce,59,Tennessee St.,117,-58
2023-12-28,Tennessee Martin,91,Tennessee St.,75,16
2023-12-30,Little Rock,82,Tennessee St.,90,-8
2023-11-14,Lipscomb,96,Tennessee Tech,65,31
2023-11-16,Midway,70,Tennessee Tech,82,-12
2023-11-28,Western Carolina,69,Tennessee Tech,65,4
2023-12-03,Alice Lloyd,82,Tennessee Tech,108,-26
2023-12-12,Bethel TN,74,Tennessee Tech,81,-7
2023-12-16,North Alabama,67,Tennessee Tech,70,-3
2023-12-28,Little Rock,81,Tennessee Tech,75,6
2023-12-30,Tennessee Martin,81,Tennessee Tech,73,8
2023-11-06,Incarnate Word,56,Texas,88,-32
2023-11-10,Delaware St.,59,Texas,86,-27
2023-11-15,Rice,64,Texas,80,-16
2023-11-20,Connecticut,81,Texas,71,10
2023-11-26,Wyoming,63,Texas,86,-23
2023-11-30,Texas St.,58,Texas,77,-19
2023-12-09,Houston Christian,50,Texas,77,-27
2023-12-16,LSU,85,Texas,96,-11
2023-12-22,Texas A&M Corpus Chris,55,Texas,71,-16
2023-12-29,UNC Greensboro,37,Texas,72,-35
2023-11-06,Texas A&M Commerce,46,Texas A&M,78,-32
2023-11-17,Oral Roberts,66,Texas A&M,74,-8
2023-11-23,Penn St.,77,Texas A&M,89,-12
2023-12-06,DePaul,64,Texas A&M,89,-25
2023-12-10,Memphis,81,Texas A&M,75,6
2023-12-22,Houston Christian,52,Texas A&M,79,-27
2023-12-30,Prairie View A&M,54,Texas A&M,79,-25
2023-11-15,Science and Arts,63,Texas A&M Commerce,113,-50
2023-11-20,Stonehill,86,Texas A&M Commerce,97,-11
2023-11-26,Denver,71,Texas A&M Commerce,61,10
2023-11-29,Dallas Christian,48,Texas A&M Commerce,100,-52
2023-12-11,Northern Colorado,99,Texas A&M Commerce,101,-2
2023-12-18,Arlington Baptist,53,Texas A&M Commerce,130,-77
2023-11-07,Southwestern Adventist,46,Texas A&M Corpus Chris,111,-65
2023-11-13,Dallas Christian,45,Texas A&M Corpus Chris,104,-59
2023-12-06,UT Rio Grande Valley,76,Texas A&M Corpus Chris,74,2
2023-12-09,Nebraska Omaha,58,Texas A&M Corpus Chris,62,-4
2023-12-18,Texas Lutheran,50,Texas A&M Corpus Chris,102,-52
2023-12-30,Schreiner,61,Texas A&M Corpus Chris,84,-23
2023-12-17,Howard,78,Texas Southern,79,-1
2023-12-21,Samford,87,Texas Southern,65,22
2023-12-28,Biblical Studies,72,Texas Southern,108,-36
2023-11-17,UTSA,62,Texas St.,72,-10
2023-11-22,Southern Utah,74,Texas St.,67,7
2023-12-11,Jarvis Christian,58,Texas St.,107,-49
2023-12-18,LeTourneau,68,Texas St.,110,-42
2023-11-08,Texas A&M Commerce,46,Texas Tech,73,-27
2023-11-12,San Jose St.,42,Texas Tech,56,-14
2023-11-16,Texas A&M Corpus Chris,64,Texas Tech,73,-9
2023-11-22,Villanova,85,Texas Tech,69,16
2023-11-23,Northern Iowa,70,Texas Tech,72,-2
2023-12-06,Nebraska Omaha,58,Texas Tech,87,-29
2023-12-12,Oral Roberts,76,Texas Tech,82,-6
2023-12-16,Vanderbilt,54,Texas Tech,76,-22
2023-12-21,UT Arlington,66,Texas Tech,77,-11
2023-12-28,Sam Houston St.,60,Texas Tech,96,-36
2023-11-10,Boston College,75,The Citadel,71,4
2023-11-16,North Greenville,59,The Citadel,77,-18
2023-11-21,North Carolina Central,61,The Citadel,67,-6
2023-11-28,Charleston Southern,52,The Citadel,81,-29
2023-12-05,Pfeiffer,60,The Citadel,88,-28
2023-12-30,Toccoa Falls,76,The Citadel,106,-30
2023-11-06,Detroit Mercy,60,Toledo,94,-34
2023-11-11,Louisiana,78,Toledo,87,-9
2023-11-22,UC Irvine,77,Toledo,71,6
2023-12-02,George Mason,86,Toledo,77,9
2023-12-09,Northern Iowa,80,Toledo,84,-4
2023-12-13,Marshall,87,Toledo,88,-1
2023-12-20,Vermont,86,Toledo,60,26
2023-11-12,Robert Morris,62,Towson,66,-4
2023-11-16,Houston,65,Towson,49,16
2023-11-19,North Texas,65,Towson,39,26
2023-11-26,Morgan St.,58,Towson,67,-9
2023-12-06,Massachusetts,71,Towson,81,-10
2023-12-22,Nicholls St.,55,Towson,65,-10
2023-12-30,Arcadia,46,Towson,97,-51
2023-11-06,Fort Lauderdale,47,Troy,92,-45
2023-11-14,Reinhardt,46,Troy,111,-65
2023-11-20,Sam Houston St.,88,Troy,86,2
2023-11-24,Grambling St.,67,Troy,80,-13
2023-12-01,SIU Edwardsville,60,Troy,83,-23
2023-12-12,Southern New Orleans,63,Troy,110,-47
2023-12-21,Eastern Kentucky,81,Troy,88,-7
2023-11-06,Nicholls St.,81,Tulane,91,-10
2023-11-09,Northwestern St.,71,Tulane,88,-17
2023-11-17,Sacramento St.,57,Tulane,92,-35
2023-11-20,Bradley,80,Tulane,77,3
2023-11-29,Prairie View A&M,77,Tulane,98,-21
2023-12-14,Furman,110,Tulane,117,-7
2023-12-16,Southern,81,Tulane,105,-24
2023-12-22,George Mason,69,Tulane,66,3
2023-12-29,Dillard,64,Tulane,94,-30
2023-11-06,Central Arkansas,53,Tulsa,70,-17
2023-11-11,Incarnate Word,71,Tulsa,85,-14
2023-11-16,Jackson St.,52,Tulsa,72,-20
2023-11-20,South Carolina St.,70,Tulsa,90,-20
2023-12-05,Loyola Chicago,77,Tulsa,88,-11
2023-12-16,Missouri St.,72,Tulsa,73,-1
2023-12-19,Mississippi Valley St.,50,Tulsa,79,-29
2023-12-22,New Mexico St.,59,Tulsa,65,-6
2023-12-29,Southwestern Oklahoma,54,Tulsa,95,-41
2023-11-06,Bradley,73,UAB,71,2
2023-11-10,Clemson,77,UAB,76,1
2023-11-12,Maryland,63,UAB,66,-3
2023-11-16,Alcorn St.,77,UAB,80,-3
2023-11-25,Furman,86,UAB,92,-6
2023-11-28,McNeese St.,81,UAB,60,21
2023-12-01,Southern Miss,85,UAB,82,3
2023-12-17,Montevallo,56,UAB,92,-36
2023-12-22,Drake,78,UAB,79,-1
2023-12-29,UNC Asheville,85,UAB,90,-5
2023-11-06,Jessup,51,UC Davis,86,-35
2023-11-09,Pepperdine,78,UC Davis,79,-1
2023-11-14,North Dakota St.,53,UC Davis,68,-15
2023-11-26,Sacramento St.,69,UC Davis,63,6
2023-12-09,Milwaukee,81,UC Davis,79,2
2023-12-19,Montana,73,UC Davis,61,12
2023-12-21,California Merced,57,UC Davis,80,-23
2023-12-28,UC Santa Barbara,62,UC Davis,76,-14
2023-12-30,Cal Poly,46,UC Davis,71,-25
2023-11-11,New Mexico St.,74,UC Irvine,91,-17
2023-11-17,Occidental,51,UC Irvine,111,-60
2023-11-21,Pepperdine,60,UC Irvine,76,-16
2023-11-24,Rice,68,UC Irvine,83,-15
2023-12-16,South Dakota,78,UC Irvine,121,-43
2023-12-28,UC Riverside,66,UC Irvine,73,-7
2023-11-07,California Merced,69,UC Riverside,76,-7
2023-11-26,Bethesda,63,UC Riverside,109,-46
2023-12-03,North Dakota,62,UC Riverside,68,-6
2023-12-16,Cal Baptist,70,UC Riverside,69,1
2023-12-21,Idaho,67,UC Riverside,82,-15
2023-12-30,UC Santa Barbara,77,UC Riverside,79,-2
2023-11-06,Denver,87,UC San Diego,95,-8
2023-11-11,San Diego,63,UC San Diego,69,-6
2023-11-13,La Verne,57,UC San Diego,116,-59
2023-11-18,Navy,55,UC San Diego,73,-18
2023-12-01,San Diego St.,63,UC San Diego,62,1
2023-12-05,Occidental,67,UC San Diego,98,-31
2023-12-28,Cal St. Bakersfield,64,UC San Diego,76,-12
2023-11-09,Portland St.,82,UC Santa Barbara,76,6
2023-11-19,Le Moyne,72,UC Santa Barbara,96,-24
2023-11-22,Westmont,79,UC Santa Barbara,91,-12
2023-11-29,Northern Arizona,59,UC Santa Barbara,70,-11
2023-12-09,Bethesda,76,UC Santa Barbara,126,-50
2023-12-20,Howard,81,UC Santa Barbara,94,-13
2023-11-06,FIU,62,UCF,85,-23
2023-11-16,Cal St. Fullerton,44,UCF,72,-28
2023-11-19,South Dakota St.,80,UCF,83,-3
2023-11-20,Charlotte,71,UCF,74,-3
2023-11-26,Stetson,85,UCF,82,3
2023-12-02,Lipscomb,57,UCF,72,-15
2023-12-06,Jacksonville,52,UCF,94,-42
2023-12-10,Mississippi,70,UCF,68,2
2023-12-18,Maine,51,UCF,74,-23
2023-12-21,Florida A&M,56,UCF,69,-13
2023-12-29,Bethune Cookman,54,UCF,98,-44
2023-11-06,Saint Francis,44,UCLA,75,-31
2023-11-10,Lafayette,50,UCLA,68,-18
2023-11-15,LIU,58,UCLA,78,-20
2023-11-22,Gonzaga,69,UCLA,65,4
2023-11-30,UC Riverside,65,UCLA,66,-1
2023-12-19,Cal St. Northridge,76,UCLA,72,4
2023-12-22,Maryland,69,UCLA,60,9
2023-11-11,Marist,65,UMBC,59,6
2023-11-14,Penn St. York,65,UMBC,84,-19
2023-11-17,Sacred Heart,80,UMBC,85,-5
2023-11-19,Loyola MD,79,UMBC,94,-15
2023-12-02,Lehigh,87,UMBC,92,-5
2023-12-09,Towson,89,UMBC,73,16
2023-12-29,American,87,UMBC,85,2
2023-11-06,Avila,48,UMKC,79,-31
2023-11-11,Saint Mary,42,UMKC,95,-53
2023-11-24,UNC Greensboro,76,UMKC,64,12
2023-11-30,Southeast Missouri St.,44,UMKC,74,-30
2023-12-12,Tabor,57,UMKC,80,-23
2023-12-29,Oral Roberts,60,UMKC,77,-17
2023-11-06,Rivier,51,UMass Lowell,96,-45
2023-12-05,Fisher,69,UMass Lowell,117,-48
2023-12-12,LIU,65,UMass Lowell,78,-13
2023-12-16,Central Connecticut,57,UMass Lowell,54,3
2023-12-31,Emerson,48,UMass Lowell,116,-68
2023-11-11,UNC Wilmington,83,UNC Asheville,66,17
2023-11-14,Carolina,54,UNC Asheville,117,-63
2023-11-18,Virginia Lynchburg,59,UNC Asheville,114,-55
2023-11-25,Wofford,82,UNC Asheville,85,-3
2023-11-26,Western Kentucky,67,UNC Asheville,77,-10
2023-12-01,Johnson TN,51,UNC Asheville,97,-46
2023-12-18,South Carolina St.,75,UNC Asheville,79,-4
2023-12-23,Kennesaw St.,70,UNC Asheville,79,-9
2023-11-10,North Carolina A&T,78,UNC Greensboro,94,-16
2023-12-01,William Peace,56,UNC Greensboro,88,-32
2023-12-07,Eastern Kentucky,85,UNC Greensboro,87,-2
2023-12-10,Elon,73,UNC Greensboro,82,-9
2023-12-21,Virginia Lynchburg,57,UNC Greensboro,135,-78
2023-11-06,Mount Olive,66,UNC Wilmington,105,-39
2023-11-14,Columbia International,80,UNC Wilmington,116,-36
2023-12-10,Montreat,50,UNC Wilmington,119,-69
2023-11-08,Southern,85,UNLV,71,14
2023-11-11,Stetson,55,UNLV,71,-16
2023-11-20,Florida St.,83,UNLV,75,8
2023-11-28,Akron,70,UNLV,72,-2
2023-12-09,Loyola Marymount,78,UNLV,75,3
2023-12-13,Creighton,64,UNLV,79,-15
2023-12-21,Hofstra,56,UNLV,74,-18
2023-12-31,Carroll MT,51,UNLV,87,-36
2023-11-09,Cal St. Bakersfield,59,USC,85,-26
2023-11-14,UC Irvine,70,USC,60,10
2023-11-19,Brown,70,USC,81,-11
2023-11-23,Seton Hall,63,USC,71,-8
2023-11-24,Oklahoma,72,USC,70,2
2023-11-29,Eastern Washington,78,USC,106,-28
2023-12-02,Gonzaga,89,USC,76,13
2023-12-10,Long Beach St.,84,USC,79,5
2023-11-12,Carolina,48,USC Upstate,106,-58
2023-11-25,Voorhees,44,USC Upstate,79,-35
2023-12-09,Kennesaw St.,84,USC Upstate,77,7
2023-12-16,Western Carolina,70,USC Upstate,53,17
2023-12-30,Coker,76,USC Upstate,96,-20
2023-11-06,Oral Roberts,71,UT Arlington,75,-4
2023-11-11,Texas Tyler,64,UT Arlington,95,-31
2023-11-22,Alcorn St.,69,UT Arlington,82,-13
2023-11-25,Texas St.,73,UT Arlington,66,7
2023-11-29,Abilene Christian,71,UT Arlington,86,-15
2023-12-06,UNT Dallas,37,UT Arlington,74,-37
2023-12-16,Air Force,73,UT Arlington,76,-3
2023-11-06,Southwestern Adventist,59,UT Rio Grande Valley,110,-51
2023-11-20,North American,73,UT Rio Grande Valley,92,-19
2023-11-29,Grand Canyon,79,UT Rio Grande Valley,69,10
2023-12-15,Texas A&M Corpus Chris,86,UT Rio Grande Valley,76,10
2023-12-30,Incarnate Word,74,UT Rio Grande Valley,77,-3
2023-11-06,McMurry,71,UTEP,120,-49
2023-11-09,Science and Arts,72,UTEP,123,-51
2023-11-13,UC Santa Barbara,76,UTEP,89,-13
2023-11-17,Austin Peay,63,UTEP,71,-8
2023-11-22,Bradley,63,UTEP,59,4
2023-11-29,Texas A&M Corpus Chris,67,UTEP,63,4
2023-12-04,Western New Mexico,62,UTEP,90,-28
2023-12-20,Norfolk St.,65,UTEP,67,-2
2023-12-21,Wyoming,67,UTEP,78,-11
2023-12-30,Seattle,73,UTEP,61,12
2023-11-06,Western Illinois,68,UTSA,78,-10
2023-11-24,Jacksonville St.,77,UTSA,62,15
2023-11-25,Incarnate Word,80,UTSA,90,-10
2023-11-30,Lamar,83,UTSA,86,-3
2023-12-10,Arkansas Fort Smith,60,UTSA,93,-33
2023-12-21,Army,63,UTSA,53,10
2023-12-28,Prairie View A&M,89,UTSA,103,-14
2023-11-06,Eastern Washington,66,Utah,101,-35
2023-11-10,UC Riverside,53,Utah,82,-29
2023-11-17,Houston,76,Utah,66,10
2023-11-19,St. John's,91,Utah,82,9
2023-11-30,Hawaii,66,Utah,79,-13
2023-12-05,Southern Utah,86,Utah,88,-2
2023-12-09,BYU,69,Utah,73,-4
2023-12-16,Utah Valley,62,Utah,76,-14
2023-12-20,Bellarmine,43,Utah,85,-42
2023-12-29,Washington St.,58,Utah,80,-22
2023-12-31,Washington,90,Utah,95,-5
2023-11-06,South Dakota Mines,48,Utah St.,101,-53
2023-11-14,Southern Utah,84,Utah St.,93,-9
2023-11-19,Marshall,60,Utah St.,83,-23
2023-11-21,Stephen F. Austin,49,Utah St.,79,-30
2023-12-02,UC Irvine,69,Utah St.,79,-10
2023-12-06,San Diego,81,Utah St.,108,-27
2023-12-09,Northwest Nazarene,53,Utah St.,84,-31
2023-12-16,San Francisco,53,Utah St.,54,-1
2023-12-22,East Tennessee St.,65,Utah St.,80,-15
2023-12-02,Utah Valley,53,Utah Tech,65,-12
2023-12-09,Idaho,63,Utah Tech,62,1
2023-12-16,North Dakota,79,Utah Tech,62,17
2023-12-30,FIU,92,Utah Tech,96,-4
2023-11-06,Carroll MT,73,Utah Valley,81,-8
2023-11-24,Western Colorado,52,Utah Valley,87,-35
2023-11-29,Seattle,72,Utah Valley,78,-6
2023-12-05,Weber St.,54,Utah Valley,70,-16
2023-12-20,Liberty,79,Utah Valley,63,16
2023-11-06,McNeese St.,76,VCU,65,11
2023-11-10,Samford,65,VCU,75,-10
2023-11-15,Radford,50,VCU,73,-23
2023-11-18,Seattle,56,VCU,60,-4
2023-11-23,Iowa St.,68,VCU,64,4
2023-11-26,Penn St.,74,VCU,86,-12
2023-12-01,Norfolk St.,63,VCU,60,3
2023-12-06,Memphis,85,VCU,80,5
2023-12-10,Alcorn St.,58,VCU,86,-28
2023-12-16,Temple,78,VCU,87,-9
2023-12-22,Maryland Eastern Shore,51,VCU,75,-24
2023-12-30,Gardner Webb,73,VCU,87,-14
2023-11-09,Christendom,53,VMI,87,-34
2023-11-17,South Dakota,85,VMI,81,4
2023-11-25,Clarks Summit,63,VMI,100,-37
2023-12-02,Presbyterian,75,VMI,71,4
2023-12-09,American,77,VMI,69,8
2023-12-22,Penn State New Kensing,65,VMI,82,-17
2023-11-06,Trinity Christian,61,Valparaiso,100,-39
2023-11-10,IUPUI,66,Valparaiso,56,10
2023-11-14,Green Bay,59,Valparaiso,64,-5
2023-11-21,Western Illinois,66,Valparaiso,73,-7
2023-11-25,Southern,59,Valparaiso,71,-12
2023-11-29,Drake,83,Valparaiso,65,18
2023-12-16,Chicago St.,63,Valparaiso,62,1
2023-12-19,Samford,79,Valparaiso,61,18
2023-11-07,Presbyterian,68,Vanderbilt,62,6
2023-11-10,USC Upstate,67,Vanderbilt,74,-7
2023-11-14,UNC Greensboro,70,Vanderbilt,74,-4
2023-11-17,Central Arkansas,71,Vanderbilt,75,-4
2023-11-23,N.C. State,84,Vanderbilt,78,6
2023-11-29,Boston College,80,Vanderbilt,62,18
2023-12-02,Alabama A&M,59,Vanderbilt,78,-19
2023-12-06,San Francisco,73,Vanderbilt,60,13
2023-12-19,Western Carolina,63,Vanderbilt,62,1
2023-12-30,Dartmouth,53,Vanderbilt,69,-16
2023-11-06,Merrimack,55,Vermont,67,-12
2023-11-11,Plattsburgh St.,41,Vermont,92,-51
2023-11-16,Charleston,64,Vermont,73,-9
2023-11-22,Northern Vermont,57,Vermont,106,-49
2023-11-29,Dartmouth,53,Vermont,64,-11
2023-12-02,Yale,65,Vermont,66,-1
2023-12-09,Colgate,77,Vermont,71,6
2023-11-06,American,63,Villanova,90,-27
2023-11-10,Le Moyne,57,Villanova,83,-26
2023-11-17,Maryland,40,Villanova,57,-17
2023-11-23,North Carolina,81,Villanova,83,-2
2023-11-29,Saint Joseph's,78,Villanova,65,13
2023-12-02,Drexel,57,Villanova,55,2
2023-12-09,UCLA,56,Villanova,65,-9
2023-11-06,Tarleton St.,50,Virginia,80,-30
2023-11-14,North Carolina A&T,51,Virginia,80,-29
2023-11-16,Texas Southern,33,Virginia,62,-29
2023-11-20,Wisconsin,65,Virginia,41,24
2023-11-29,Texas A&M,47,Virginia,59,-12
2023-12-02,Syracuse,62,Virginia,84,-22
2023-12-05,North Carolina Central,47,Virginia,77,-30
2023-12-16,Northeastern,54,Virginia,56,-2
2023-12-27,Morgan St.,44,Virginia,79,-35
2023-11-06,Coppin St.,55,Virginia Tech,100,-45
2023-11-15,Campbell,44,Virginia Tech,60,-16
2023-11-19,Wofford,76,Virginia Tech,98,-22
2023-11-23,Boise St.,75,Virginia Tech,82,-7
2023-11-24,Iowa St.,62,Virginia Tech,71,-9
2023-11-26,Florida Atlantic,84,Virginia Tech,50,34
2023-12-03,Louisville,68,Virginia Tech,75,-7
2023-12-09,Valparaiso,50,Virginia Tech,71,-21
2023-12-16,Vermont,51,Virginia Tech,73,-22
2023-12-21,American,55,Virginia Tech,77,-22
2023-11-09,Molloy,48,Wagner,83,-35
2023-11-25,NJIT,51,Wagner,64,-13
2023-12-10,Boston University,73,Wagner,59,14
2023-12-22,Gwynedd Mercy,49,Wagner,98,-49
2023-11-06,Elon,78,Wake Forest,101,-23
2023-11-16,Utah,77,Wake Forest,70,7
2023-11-17,Towson,61,Wake Forest,71,-10
2023-11-19,LSU,86,Wake Forest,80,6
2023-11-24,Charleston Southern,56,Wake Forest,71,-15
2023-11-29,Florida,71,Wake Forest,82,-11
2023-12-06,Rutgers,57,Wake Forest,76,-19
2023-12-09,NJIT,59,Wake Forest,83,-24
2023-12-18,Delaware St.,59,Wake Forest,88,-29
2023-12-21,Presbyterian,68,Wake Forest,91,-23
2023-12-30,Virginia Tech,63,Wake Forest,86,-23
2023-11-06,Bellarmine,57,Washington,91,-34
2023-11-09,Northern Kentucky,67,Washington,75,-8
2023-11-12,Nevada,83,Washington,76,7
2023-11-17,Xavier,71,Washington,74,-3
2023-11-19,San Diego St.,100,Washington,97,3
2023-11-28,UC San Diego,56,Washington,83,-27
2023-12-02,Colorado St.,86,Washington,81,5
2023-12-05,Montana St.,61,Washington,85,-24
2023-12-09,Gonzaga,73,Washington,78,-5
2023-12-21,Eastern Washington,66,Washington,73,-7
2023-11-06,Idaho,59,Washington St.,84,-25
2023-11-10,Prairie View A&M,65,Washington St.,83,-18
2023-11-18,Mississippi St.,76,Washington St.,64,12
2023-11-24,Utah Tech,53,Washington St.,93,-40
2023-11-27,Eastern Washington,72,Washington St.,82,-10
2023-12-02,Portland St.,61,Washington St.,71,-10
2023-12-06,UC Riverside,49,Washington St.,86,-37
2023-12-10,Grambling St.,65,Washington St.,83,-18
2023-12-16,Santa Clara,69,Washington St.,61,8
2023-12-21,Boise St.,61,Washington St.,66,-5
2023-11-07,Benedictine Mesa,62,Weber St.,96,-34
2023-11-17,Gardner Webb,62,Weber St.,61,1
2023-11-19,Colgate,57,Weber St.,55,2
2023-11-27,Navajo Tech,45,Weber St.,107,-62
2023-12-09,Cal Poly,50,Weber St.,78,-28
2023-12-21,Park Gilbert,39,Weber St.,90,-51
2023-12-28,Montana,63,Weber St.,93,-30
2023-12-30,Montana St.,64,Weber St.,86,-22
2023-11-06,Missouri St.,59,West Virginia,67,-8
2023-11-10,Monmouth,73,West Virginia,65,8
2023-11-14,Jacksonville St.,57,West Virginia,70,-13
2023-11-22,Virginia,56,West Virginia,54,2
2023-11-26,Bellarmine,58,West Virginia,62,-4
2023-12-01,St. John's,79,West Virginia,73,6
2023-12-06,Pittsburgh,80,West Virginia,63,17
2023-12-09,Drexel,60,West Virginia,66,-6
2023-12-20,Radford,66,West Virginia,65,1
2023-12-23,Toledo,81,West Virginia,91,-10
2023-11-07,Dalton St.,65,Western Carolina,106,-41
2023-11-18,McNeese St.,74,Western Carolina,76,-2
2023-11-26,North Alabama,63,Western Carolina,81,-18
2023-12-09,UNC Asheville,63,Western Carolina,78,-15
2023-12-21,Brescia,47,Western Carolina,85,-38
2023-12-30,King,62,Western Carolina,90,-28
2023-11-12,St. Ambrose,59,Western Illinois,94,-35
2023-11-17,Southern,80,Western Illinois,88,-8
2023-11-30,Hannibal LaGrange,40,Western Illinois,92,-52
2023-12-03,South Dakota,70,Western Illinois,68,2
2023-12-06,Coe,58,Western Illinois,80,-22
2023-12-18,Eureka,56,Western Illinois,92,-36
2023-11-06,Kentucky Wesleyan,64,Western Kentucky,90,-26
2023-11-18,Kentucky St.,75,Western Kentucky,95,-20
2023-11-25,Canisius,85,Western Kentucky,77,8
2023-11-29,Campbellsville,77,Western Kentucky,101,-24
2023-12-03,Eastern Kentucky,69,Western Kentucky,79,-10
2023-12-16,Austin Peay,64,Western Kentucky,65,-1
2023-12-30,Abilene Christian,84,Western Kentucky,86,-2
2023-11-06,North Dakota St.,80,Western Michigan,76,4
2023-11-11,Georgia St.,77,Western Michigan,70,7
2023-11-24,Southeastern Louisiana,67,Western Michigan,68,-1
2023-11-25,Mercer,66,Western Michigan,72,-6
2023-12-01,St. Thomas,66,Western Michigan,51,15
2023-12-09,Youngstown St.,72,Western Michigan,68,4
2023-12-29,Aquinas,71,Western Michigan,127,-56
2023-11-06,Lipscomb,59,Wichita St.,76,-17
2023-11-09,Western Kentucky,61,Wichita St.,71,-10
2023-11-12,Friends,65,Wichita St.,95,-30
2023-11-19,Saint Louis,69,Wichita St.,88,-19
2023-11-25,Norfolk St.,67,Wichita St.,80,-13
2023-11-29,Richmond,68,Wichita St.,80,-12
2023-12-09,South Dakota St.,79,Wichita St.,69,10
2023-12-16,Southern Illinois,68,Wichita St.,69,-1
2023-11-06,Regent,29,William & Mary,84,-55
2023-11-09,American,56,William & Mary,75,-19
2023-11-19,Lindenwood,71,William & Mary,60,11
2023-11-25,UMBC,81,William & Mary,96,-15
2023-12-06,Old Dominion,79,William & Mary,84,-5
2023-12-10,Virginia Lynchburg,50,William & Mary,99,-49
2023-11-08,Brevard,44,Winthrop,98,-54
2023-11-11,Drexel,74,Winthrop,72,2
2023-11-17,Holy Cross,51,Winthrop,89,-38
2023-11-18,IUPUI,61,Winthrop,74,-13
2023-11-19,Elon,70,Winthrop,78,-8
2023-11-28,Bob Jones,49,Winthrop,90,-41
2023-12-05,Queens,82,Winthrop,88,-6
2023-12-29,Toccoa Falls,62,Winthrop,113,-51
2023-11-06,Arkansas St.,76,Wisconsin,105,-29
2023-11-10,Tennessee,80,Wisconsin,70,10
2023-11-17,Robert Morris,68,Wisconsin,78,-10
2023-11-27,Western Illinois,49,Wisconsin,71,-22
2023-12-02,Marquette,64,Wisconsin,75,-11
2023-12-14,Jacksonville St.,60,Wisconsin,75,-15
2023-12-22,Chicago St.,53,Wisconsin,80,-27
2023-11-06,Brevard,68,Wofford,85,-17
2023-11-11,High Point,98,Wofford,99,-1
2023-11-24,Canisius,76,Wofford,67,9
2023-11-26,Lipscomb,85,Wofford,78,7
2023-12-17,Kentucky Christian,54,Wofford,105,-51
2023-12-29,Southern Wesleyan,55,Wofford,75,-20
2023-11-14,Toledo,78,Wright St.,77,1
2023-11-20,Louisiana,85,Wright St.,91,-6
2023-11-22,Illinois St.,49,Wright St.,74,-25
2023-11-29,IUPUI,74,Wright St.,103,-29
2023-12-07,Bethel IN,62,Wright St.,81,-19
2023-12-12,Western Kentucky,91,Wright St.,84,7
2023-12-19,Miami OH,82,Wright St.,92,-10
2023-12-22,Muskingum,54,Wright St.,101,-47
2023-11-07,Northern New Mexico,56,Wyoming,104,-48
2023-11-11,Cal Poly,66,Wyoming,80,-14
2023-11-16,Saint Louis,79,Wyoming,69,10
2023-11-17,Charleston,60,Wyoming,67,-7
2023-12-05,South Dakota Mines,59,Wyoming,80,-21
2023-12-09,Stephen F. Austin,70,Wyoming,78,-8
2023-12-16,Weber St.,84,Wyoming,71,13
2023-12-20,South Dakota St.,65,Wyoming,78,-13
2023-11-06,Robert Morris,63,Xavier,77,-14
2023-11-10,Jacksonville,56,Xavier,79,-23
2023-11-19,Saint Mary's,49,Xavier,66,-17
2023-11-24,Bryant,75,Xavier,100,-25
2023-11-27,Oakland,78,Xavier,76,2
2023-12-01,Houston,66,Xavier,60,6
2023-12-05,Delaware,87,Xavier,80,7
2023-12-09,Cincinnati,79,Xavier,84,-5
2023-12-16,Winthrop,59,Xavier,75,-16
2023-12-23,Seton Hall,54,Xavier,74,-20
2023-11-06,Vassar,53,Yale,102,-49
2023-11-17,Colgate,50,Yale,68,-18
2023-11-18,Weber St.,75,Yale,65,10
2023-11-29,Stony Brook,71,Yale,79,-8
2023-12-06,Fairfield,75,Yale,71,4
2023-12-08,Colby Sawyer,36,Yale,95,-59
2023-11-13,Ohio Christian,71,Youngstown St.,99,-28
2023-11-17,Utah Tech,68,Youngstown St.,75,-7
2023-11-19,Lake Erie,57,Youngstown St.,79,-22
2023-11-29,Cleveland St.,69,Youngstown St.,94,-25
2023-12-14,Bethany WV,70,Youngstown St.,107,-37
2023-12-18,Westminster PA,45,Youngstown St.,117,-72
2023-12-21,Navy,65,Youngstown St.,75,-10
2023-12-31,Oakland,88,Youngstown St.,81,7
